RMAC	中文解释
A-APF	形容词，直接受词，复数，阴性
A-APF-C	形容词，直接受词，复数，阴性，比较级
A-APF-NUI	形容词，直接受词，复数，阴性，无变格数字（形容词）
A-APF-S	形容词，直接受词，复数，阴性，最上级
A-APM	形容词，直接受词，复数，阳性
A-APM-C	形容词，直接受词，复数，阳性，比较级
A-APM-LG	形容词，直接受词，复数，阳性，非犹太地名
A-APM-NUI	形容词，直接受词，复数，阳性，无变格数字（形容词）
A-APM-PG	形容词，直接受词，复数，阳性，非犹太人名
A-APM-S	形容词，直接受词，复数，阳性，最上级
A-APN	形容词，直接受词，复数，中性
A-APN-C	形容词，直接受词，复数，中性，比较级
A-APN-NUI	形容词，直接受词，复数，中性，无变格数字（形容词）
A-APN-S	形容词，直接受词，复数，中性，最上级
A-ASF	形容词，直接受词，单数，阴性
A-ASF-C	形容词，直接受词，单数，阴性，比较级
A-ASF-L	形容词，直接受词，单数，阴性，地名
A-ASF-LG	形容词，直接受词，单数，阴性，非犹太地名
A-ASF-N	形容词，直接受词，单数，阴性，否定词
A-ASF-PG	形容词，直接受词，单数，阴性，非犹太人名
A-ASF-S	形容词，直接受词，单数，阴性，最上级
A-ASM	形容词，直接受词，单数，阳性
A-ASM-C	形容词，直接受词，单数，阳性，比较级
A-ASM-LG	形容词，直接受词，单数，阳性，非犹太地名
A-ASM-N	形容词，直接受词，单数，阳性，否定词
A-ASM-PG	形容词，直接受词，单数，阳性，非犹太人名
A-ASM-S	形容词，直接受词，单数，阳性，最上级
A-ASN	形容词，直接受词，单数，中性
A-ASN-C	形容词，直接受词，单数，中性，比较级
A-ASN-LG	形容词，直接受词，单数，中性，非犹太地名
A-ASN-N	形容词，直接受词，单数，中性，否定词
A-ASN-S	形容词，直接受词，单数，中性，最上级
A-DPF	形容词，间接受格，复数，阴性
A-DPF-C	形容词，间接受格，复数，阴性，比较级
A-DPF-NUI	形容词，间接受格，复数，阴性，无变格数字（形容词）
A-DPF-S	形容词，间接受格，复数，阴性，最上级
A-DPM	形容词，间接受格，复数，阳性
A-DPM-C	形容词，间接受格，复数，阳性，比较级
A-DPM-LG	形容词，间接受格，复数，阳性，非犹太地名
A-DPM-NUI	形容词，间接受格，复数，阳性，无变格数字（形容词）
A-DPM-PG	形容词，间接受格，复数，阳性，非犹太人名
A-DPM-S	形容词，间接受格，复数，阳性，最上级
A-DPN	形容词，间接受格，复数，中性
A-DPN-LG	形容词，间接受格，复数，中性，非犹太地名
A-DPN-NUI	形容词，间接受格，复数，中性，无变格数字（形容词）
A-DPN-S	形容词，间接受格，复数，中性，最上级
A-DSF	形容词，间接受格，单数，阴性
A-DSF-C	形容词，间接受格，单数，阴性，比较级
A-DSF-L	形容词，间接受格，单数，阴性，地名
A-DSF-LG	形容词，间接受格，单数，阴性，非犹太地名
A-DSF-PG	形容词，间接受格，单数，阴性，非犹太人名
A-DSF-S	形容词，间接受格，单数，阴性，最上级
A-DSM	形容词，间接受格，单数，阳性
A-DSM-C	形容词，间接受格，单数，阳性，比较级
A-DSM-N	形容词，间接受格，单数，阳性，否定词
A-DSM-PG	形容词，间接受格，单数，阳性，非犹太人名
A-DSM-S	形容词，间接受格，单数，阳性，最上级
A-DSN	形容词，间接受格，单数，中性
A-DSN-C	形容词，间接受格，单数，中性，比较级
A-DSN-LG	形容词，间接受格，单数，中性，非犹太地名
A-DSN-N	形容词，间接受格，单数，中性，否定词
A-DSN-S	形容词，间接受格，单数，中性，最上级
A-GMS	形容词，所有格，阳性，最上级
A-GPF	形容词，所有格，复数，阴性
A-GPF-L	形容词，所有格，复数，阴性，地名
A-GPF-NUI	形容词，所有格，复数，阴性，无变格数字（形容词）
A-GPF-S	形容词，所有格，复数，阴性，最上级
A-GPM	形容词，所有格，复数，阳性
A-GPM-C	形容词，所有格，复数，阳性，比较级
A-GPM-LG	形容词，所有格，复数，阳性，非犹太地名
A-GPM-NUI	形容词，所有格，复数，阳性，无变格数字（形容词）
A-GPM-PG	形容词，所有格，复数，阳性，非犹太人名
A-GPM-S	形容词，所有格，复数，阳性，最上级
A-GPN	形容词，所有格，复数，中性
A-GPN-C	形容词，所有格，复数，中性，比较级
A-GPN-NUI	形容词，所有格，复数，中性，无变格数字（形容词）
A-GPN-S	形容词，所有格，复数，中性，最上级
A-GSF	形容词，所有格，单数，阴性
A-GSF-C	形容词，所有格，单数，阴性，比较级
A-GSF-L	形容词，所有格，单数，阴性，地名
A-GSF-LG	形容词，所有格，单数，阴性，非犹太地名
A-GSF-PG	形容词，所有格，单数，阴性，非犹太人名
A-GSF-S	形容词，所有格，单数，阴性，最上级
A-GSM	形容词，所有格，单数，阳性
A-GSM-C	形容词，所有格，单数，阳性，比较级
A-GSM-N	形容词，所有格，单数，阳性，否定词
A-GSM-PG	形容词，所有格，单数，阳性，非犹太人名
A-GSM-S	形容词，所有格，单数，阳性，最上级
A-GSN	形容词，所有格，单数，中性
A-GSN-N	形容词，所有格，单数，中性，否定词
A-GSN-S	形容词，所有格，单数，中性，最上级
A-NPF	形容词，主格，复数，阴性
A-NPF-C	形容词，主格，复数，阴性，比较级
A-NPF-NUI	形容词，主格，复数，阴性，无变格数字（形容词）
A-NPF-S	形容词，主格，复数，阴性，最上级
A-NPM	形容词，主格，复数，阳性
A-NPM-C	形容词，主格，复数，阳性，比较级
A-NPM-LG	形容词，主格，复数，阳性，非犹太地名
A-NPM-NUI	形容词，主格，复数，阳性，无变格数字（形容词）
A-NPM-PG	形容词，主格，复数，阳性，非犹太人名
A-NPM-S	形容词，主格，复数，阳性，最上级
A-NPN	形容词，主格，复数，中性
A-NPN-C	形容词，主格，复数，中性，比较级
A-NPN-NUI	形容词，主格，复数，中性，无变格数字（形容词）
A-NPN-S	形容词，主格，复数，中性，最上级
A-NSF	形容词，主格，单数，阴性
A-NSF-C	形容词，主格，单数，阴性，比较级
A-NSF-LG	形容词，主格，单数，阴性，非犹太地名
A-NSF-N	形容词，主格，单数，阴性，否定词
A-NSF-S	形容词，主格，单数，阴性，最上级
A-NSM	形容词，主格，单数，阳性
A-NSM-ATT	形容词，主格，单数，阳性，阿提卡希腊语
A-NSM-C	形容词，主格，单数，阳性，比较级
A-NSM-LG	形容词，主格，单数，阳性，非犹太地名
A-NSM-N	形容词，主格，单数，阳性，否定词
A-NSM-PG	形容词，主格，单数，阳性，非犹太人名
A-NSM-S	形容词，主格，单数，阳性，最上级
A-NSM-T	形容词，主格，单数，阳性，称谓
A-NSN	形容词，主格，单数，中性
A-NSN-C	形容词，主格，单数，中性，比较级
A-NSN-N	形容词，主格，单数，中性，中性
A-NSN-S	形容词，主格，单数，中性，最上级
A-NUI	无变格数字（形容词）
A-NUI-ABB	形容词，主格，缩写形式
A-VPF	形容词，呼格，复数，阴性
A-VPM	形容词，呼格，复数，阳性
A-VPM-C	形容词，呼格，复数，阳性，比较级
A-VPM-PG	形容词，呼格，复数，阳性，非犹太人名
A-VPN	形容词，呼格，复数，中性
A-VSF	形容词，呼格，单数，阴性
A-VSM	形容词，呼格，单数，阳性
A-VSM-S	形容词，呼格，单数，阳性，最上级
A-VSN	形容词，呼格，单数，中性
ADV	副词／副词＋质词
ADV-C	副词，缩略形式
ADV-I	副词，疑问词
ADV-K	副词，Kai
ADV-N	副词，否定词
ADV-S	副词，最上级
ARAM	亚兰文音译词（无变格）
C-APM	互相代名词，直接受词，复数，阳性
C-DPM	互相代名词，间接受格，复数，阳性
C-DPN	互相代名词，间接受格，复数，中性
C-GPM	互相代名词，所有格，复数，阳性
C-GPN	互相代名词，所有格，复数，中性
COND	条件质词或连接词
COND-C	缩略形式
COND-K	条件质词，Kai
COND-P	缩略形式
CONJ	连接词／连接质词
CONJ-N	连接词，否定词
D-APF	指示代名词，直接受词，复数，阴性
D-APM	指示代名词，直接受词，复数，阳性
D-APM-C	指示代名词，直接受词，复数，阳性，缩略形式
D-APM-K	指示代名词，直接受词，复数，阳性，Kai
D-APN	指示代名词，直接受词，复数，中性
D-APN-K	指示代名词，直接受词，复数，中性，Kai
D-ASF	指示代名词，直接受词，单数，阴性
D-ASM	指示代名词，直接受词，单数，阳性
D-ASM-C	指示代名词，直接受词，单数，阳性，缩略形式
D-ASM-K	指示代名词，直接受词，单数，阳性，Kai
D-ASN	指示代名词，直接受词，单数，中性
D-DPF	指示代名词，间接受格，复数，阴性
D-DPM	指示代名词，间接受格，复数，阳性
D-DPM-C	指示代名词，间接受格，复数，阳性，缩略形式
D-DPN	指示代名词，间接受格，复数，中性
D-DSF	指示代名词，间接受格，单数，阴性
D-DSM	指示代名词，间接受格，单数，阳性
D-DSN	指示代名词，间接受格，单数，中性
D-GPF	指示代名词，所有格，复数，阴性
D-GPM	指示代名词，所有格，复数，阳性
D-GPN	指示代名词，所有格，复数，中性
D-GSF	指示代名词，所有格，单数，阴性
D-GSM	指示代名词，所有格，单数，阳性
D-GSN	指示代名词，所有格，单数，中性
D-NPF	指示代名词，主格，复数，阴性
D-NPM	指示代名词，主格，复数，阳性
D-NPM-C	指示代名词，主格，复数，阳性，缩略形式
D-NPM-K	指示代名词，主格，复数，阳性，Kai
D-NPN	指示代名词，主格，复数，中性
D-NPN-C	指示代名词，主格，复数，中性，缩略形式
D-NPN-K	指示代名词，主格，复数，中性，Kai
D-NSF	指示代名词，主格，单数，阴性
D-NSM	指示代名词，主格，单数，阳性
D-NSM-C	指示代名词，主格，单数，阳性，缩略形式
D-NSM-K	指示代名词，主格，单数，阳性，Kai
D-NSN	指示代名词，主格，单数，中性
F-1APM	反身代名词，第一人称，直接受词，复数，阳性
F-1ASM	反身代名词，第一人称，直接受词，单数，阳性
F-1DPM	反身代名词，第一人称，间接受格，复数，阳性
F-1DSM	反身代名词，第一人称，间接受格，单数，阳性
F-1GPM	反身代名词，第一人称，所有格，复数，阳性
F-1GSM	反身代名词，第一人称，所有格，单数，阳性
F-2APF	反身代名词，第二人称，直接受词，复数，阴性
F-2APM	反身代名词，第二人称，直接受词，复数，阳性
F-2APN	反身代名词，第二人称，直接受词，复数，中性
F-2ASM	反身代名词，第二人称，直接受词，单数，阳性
F-2ASM-C	反身代名词，第二人称，直接受词，单数，阳性，缩略形式
F-2DPF	反身代名词，第二人称，间接受格，复数，阴性
F-2DPM	反身代名词，第二人称，间接受格，复数，阳性
F-2DSM	反身代名词，第二人称，间接受格，单数，阳性
F-2GPM	反身代名词，第二人称，所有格，复数，阳性
F-2GSM	反身代名词，第二人称，所有格，单数，阳性
F-3APF	反身代名词，第三人称，直接受词，复数，阴性
F-3APM	反身代名词，第三人称，直接受词，复数，阳性
F-3APN	反身代名词，第三人称，直接受词，复数，中性
F-3ASF	反身代名词，第三人称，直接受词，单数，阴性
F-3ASM	反身代名词，第三人称，直接受词，单数，阳性
F-3ASN	反身代名词，第三人称，直接受词，单数，中性
F-3DPF	反身代名词，第三人称，间接受格，复数，阴性
F-3DPM	反身代名词，第三人称，间接受格，复数，阳性
F-3DSF	反身代名词，第三人称，间接受格，单数，阴性
F-3DSM	反身代名词，第三人称，间接受格，单数，阳性
F-3GPF	反身代名词，第三人称，所有格，复数，阴性
F-3GPM	反身代名词，第三人称，所有格，复数，阳性
F-3GPN	反身代名词，第三人称，所有格，复数，中性
F-3GSF	反身代名词，第三人称，所有格，单数，阴性
F-3GSM	反身代名词，第三人称，所有格，单数，阳性
F-3GSN	反身代名词，第三人称，所有格，单数，中性
F-3NSM	反身代名词，第三人称，主格，单数，阳性
F-GPF	反身代名词，所有格，复数，阴性
HEB	希伯来文音译词（无变格）
HEB-T	希伯来文，称谓
I-APF	疑问代名词，直接受词，复数，阴性
I-APM	疑问代名词，直接受词，复数，阳性
I-APN	疑问代名词，直接受词，复数，中性
I-ASF	疑问代名词，直接受词，单数，阴性
I-ASM	疑问代名词，直接受词，单数，阳性
I-ASN	疑问代名词，直接受词，单数，中性
I-DPM	疑问代名词，间接受格，复数，阳性
I-DPN	疑问代名词，间接受格，复数，中性
I-DSF	疑问代名词，间接受格，单数，阴性
I-DSM	疑问代名词，间接受格，单数，阳性
I-DSN	疑问代名词，间接受格，单数，中性
I-GPM	疑问代名词，所有格，复数，阳性
I-GPN	疑问代名词，所有格，复数，中性
I-GSF	疑问代名词，所有格，单数，阴性
I-GSM	疑问代名词，所有格，单数，阳性
I-GSN	疑问代名词，所有格，单数，中性
I-NPF	疑问代名词，主格，复数，阴性
I-NPM	疑问代名词，主格，复数，阳性
I-NPN	疑问代名词，主格，复数，中性
I-NSF	疑问代名词，主格，单数，阴性
I-NSM	疑问代名词，主格，单数，阳性
I-NSN	疑问代名词，主格，单数，中性
INJ	感叹词
K-APF	相关代名词，直接受词，复数，阴性
K-APM	相关代名词，直接受词，复数，阳性
K-APN	相关代名词，直接受词，复数，中性
K-ASM	相关代名词，直接受词，单数，阳性
K-ASN	相关代名词，直接受词，单数，中性
K-DSN	相关代名词，间接受格，单数，中性
K-GPM	相关代名词，所有格，复数，阳性
K-GSN	相关代名词，所有格，单数，中性
K-NPF	相关代名词，主格，复数，阴性
K-NPM	相关代名词，主格，复数，阳性
K-NPN	相关代名词，主格，复数，中性
K-NSF	相关代名词，主格，单数，阴性
K-NSM	相关代名词，主格，单数，阳性
K-NSN	相关代名词，主格，单数，中性
N-APF	名词，直接受词，复数，阴性
N-APF-C	名词，直接受词，复数，阴性，缩略形式
N-APF-L	名词，直接受词，复数，阴性，地名
N-APF-S	名词，直接受词，复数，阴性，最上级
N-APM	名词，直接受词，复数，阳性
N-APM-L	名词，直接受词，复数，阳性，地名
N-APM-LG	名词，直接受词，复数，阳性，非犹太地名
N-APM-P	名词，直接受词，复数，阳性，人名
N-APM-PG	名词，直接受词，复数，阳性，非犹太人名
N-APM-T	名词，直接受词，复数，阳性，称谓
N-APN	名词，直接受词，复数，中性
N-APN-C	名词，直接受词，复数，中性，缩略形式
N-APN-L	名词，直接受词，复数，中性，地名
N-APN-S	名词，直接受词，复数，中性，最上级
N-ASF	名词，直接受词，单数，阴性
N-ASF-C	名词，直接受词，单数，阴性，缩略形式
N-ASF-L	名词，直接受词，单数，阴性，地名
N-ASF-P	名词，直接受词，单数，阴性，人名
N-ASF-S	名词，直接受词，单数，阴性，最上级
N-ASF-T	名词，直接受词，单数，阴性，称谓
N-ASM	名词，直接受词，单数，阳性
N-ASM-L	名词，直接受词，单数，阳性，地名
N-ASM-LG	名词，直接受词，单数，阳性，非犹太地名
N-ASM-P	名词，直接受词，单数，阳性，人名
N-ASM-S	名词，直接受词，单数，阳性，最上级
N-ASM-T	名词，直接受词，单数，阳性，称谓
N-ASN	名词，直接受词，单数，中性
N-ASN-L	名词，直接受词，单数，中性，地名
N-DPF	名词，间接受格，复数，阴性
N-DPF-L	名词，间接受格，复数，阴性，地名
N-DPM	名词，间接受格，复数，阳性
N-DPM-L	名词，间接受格，复数，阳性，地名
N-DPM-LG	名词，间接受格，复数，阳性，非犹太地名
N-DPM-S	名词，间接受格，复数，阳性，最上级
N-DPM-T	名词，间接受格，复数，阳性，称谓
N-DPN	名词，间接受格，复数，中性
N-DPN-L	名词，间接受格，复数，中性，地名
N-DSF	名词，间接受格，单数，阴性
N-DSF-L	名词，间接受格，单数，阴性，地名
N-DSF-LG	名词，间接受格，单数，阴性，非犹太地名
N-DSF-P	名词，间接受格，单数，阴性，人名
N-DSF-T	名词，间接受格，单数，阴性，称谓
N-DSM	名词，间接受格，单数，阳性
N-DSM-L	名词，间接受格，单数，阳性，地名
N-DSM-LG	名词，间接受格，单数，阳性，非犹太地名
N-DSM-P	名词，间接受格，单数，阳性，人名
N-DSM-T	名词，间接受格，单数，阳性，称谓
N-DSN	名词，间接受格，单数，中性
N-DSN-L	名词，间接受格，单数，中性，地名
N-GMP	名词，所有格，阳性，附属质词
N-GPF	名词，所有格，复数，阴性
N-GPF-L	名词，所有格，复数，阴性，地名
N-GPF-LG	名词，所有格，复数，阴性，非犹太地名
N-GPM	名词，所有格，复数，阳性
N-GPM-L	名词，所有格，复数，阳性，地名
N-GPM-LG	名词，所有格，复数，阳性，非犹太地名
N-GPM-PG	名词，所有格，复数，阳性，非犹太人名
N-GPM-T	名词，所有格，复数，阳性，称谓
N-GPN	名词，所有格，复数，中性
N-GPN-L	名词，所有格，复数，中性，地名
N-GSF	名词，所有格，单数，阴性
N-GSF-L	名词，所有格，单数，阴性，地名
N-GSF-LG	名词，所有格，单数，阴性，非犹太地名
N-GSF-P	名词，所有格，单数，阴性，人名
N-GSF-T	名词，所有格，单数，阴性，称谓
N-GSM	名词，所有格，单数，阳性
N-GSM-L	名词，所有格，单数，阳性，地名
N-GSM-LG	名词，所有格，单数，阳性，非犹太地名
N-GSM-P	名词，所有格，单数，阳性，人名
N-GSM-PG	名词，所有格，单数，阳性，非犹太人名
N-GSM-T	名词，所有格，单数，阳性，称谓
N-GSN	名词，所有格，单数，中性
N-GSN-L	名词，所有格，单数，中性，地名
N-LI	无变格字母（名词）
N-NAM	名词，主格
N-NPF	名词，主格，复数，阴性
N-NPM	名词，主格，复数，阳性
N-NPM-L	名词，主格，复数，阳性，地名
N-NPM-LG	名词，主格，复数，阳性，非犹太地名
N-NPM-PG	名词，主格，复数，阳性，非犹太人名
N-NPM-S	名词，主格，复数，阳性，最上级
N-NPM-T	名词，主格，复数，阳性，称谓
N-NPN	名词，主格，复数，中性
N-NPN-L	名词，主格，复数，中性，地名
N-NPN-T	名词，主格，复数，中性，称谓
N-NSF	名词，主格，单数，阴性
N-NSF-L	名词，主格，单数，阴性，地名
N-NSF-LG	名词，主格，单数，阴性，非犹太地名
N-NSF-P	名词，主格，单数，阴性，人名
N-NSF-T	名词，主格，单数，阴性，称谓
N-NSM	名词，主格，单数，阳性
N-NSM-C	名词，主格，单数，阳性，比较级
N-NSM-L	名词，主格，单数，阳性，地名
N-NSM-LG	名词，主格，单数，阳性，非犹太地名
N-NSM-P	名词，主格，单数，阳性，人名
N-NSM-PG	名词，主格，单数，阳性，非犹太人名
N-NSM-T	名词，主格，单数，阳性，称谓
N-NSN	名词，主格，单数，中性
N-NSN-C	名词，主格，单数，中性，缩略形式
N-NSN-L	名词，主格，单数，中性，地名
N-NSN-LI	名词，主格，单数，中性，无变格字母（名词）
N-NSN-T	名词，主格，单数，中性，称谓
N-OI	无变格名词
N-PRI	无变格专有名词
N-VPF	名词，呼格，复数，阴性
N-VPM	名词，呼格，复数，阳性
N-VPM-LG	名词，呼格，复数，阳性，非犹太地名
N-VPM-PG	名词，呼格，复数，阳性，非犹太人名
N-VPM-T	名词，呼格，复数，阳性，称谓
N-VPN	名词，呼格，复数，中性
N-VSF	名词，呼格，单数，阴性
N-VSF-L	名词，呼格，单数，阴性，地名
N-VSF-P	名词，呼格，单数，阴性，人名
N-VSM	名词，呼格，单数，阳性
N-VSM-L	名词，呼格，单数，阳性，地名
N-VSM-P	名词，呼格，单数，阳性，人名
N-VSM-T	名词，呼格，单数，阳性，称谓
N-VSN	名词，呼格，单数，中性
P-1AP	人称代名词，第一人称，直接受词，复数
P-1AS	人称代名词，第一人称，直接受词，单数
P-1AS-C	人称代名词，第一人称，直接受词，单数，缩略形式
P-1AS-K	人称代名词，第一人称，直接受词，单数，Kai
P-1DP	人称代名词，第一人称，间接受格，复数
P-1DS	人称代名词，第一人称，间接受格，单数
P-1DS-C	人称代名词，第一人称，间接受格，单数，缩略形式
P-1DS-K	人称代名词，第一人称，间接受格，单数，Kai
P-1GP	人称代名词，第一人称，所有格，复数
P-1GS	人称代名词，第一人称，所有格，单数
P-1NP	人称代名词，第一人称，主格，复数
P-1NS	人称代名词，第一人称，主格，单数
P-1NS-C	人称代名词，第一人称，主格，单数，缩略形式
P-1NS-K	人称代名词，第一人称，主格，单数，Kai
P-2AP	人称代名词，第二人称，直接受词，复数
P-2AS	人称代名词，第二人称，直接受词，单数
P-2DP	人称代名词，第二人称，间接受格，复数
P-2DS	人称代名词，第二人称，间接受格，单数
P-2GP	人称代名词，第二人称，所有格，复数
P-2GS	人称代名词，第二人称，所有格，单数
P-2NP	人称代名词，第二人称，主格，复数
P-2NS	人称代名词，第二人称，主格，单数
P-APF	人称代名词，直接受词，复数，阴性
P-APM	人称代名词，直接受词，复数，阳性
P-APN	人称代名词，直接受词，复数，中性
P-ASF	人称代名词，直接受词，单数，阴性
P-ASM	人称代名词，直接受词，单数，阳性
P-ASN	人称代名词，直接受词，单数，中性
P-DPF	人称代名词，间接受格，复数，阴性
P-DPM	人称代名词，间接受格，复数，阳性
P-DPN	人称代名词，间接受格，复数，中性
P-DSF	人称代名词，间接受格，单数，阴性
P-DSM	人称代名词，间接受格，单数，阳性
P-DSN	人称代名词，间接受格，单数，中性
P-GPF	人称代名词，所有格，复数，阴性
P-GPM	人称代名词，所有格，复数，阳性
P-GPN	人称代名词，所有格，复数，中性
P-GSF	人称代名词，所有格，单数，阴性
P-GSM	人称代名词，所有格，单数，阳性
P-GSN	人称代名词，所有格，单数，中性
P-NPM	人称代名词，主格，复数，阳性
P-NPN	人称代名词，主格，复数，中性
P-NSF	人称代名词，主格，单数，阴性
P-NSM	人称代名词，主格，单数，阳性
P-NSN	人称代名词，主格，单数，中性
PREP	介词
PRT	质词，反意质词
PRT-I	质词，疑问词
PRT-N	质词，否定词
Q-APF	相关或疑问代名词，直接受词，复数，阴性
Q-APM	相关或疑问代名词，直接受词，复数，阳性
Q-APN	相关或疑问代名词，直接受词，复数，中性
Q-ASF	相关或疑问代名词，直接受词，单数，阴性
Q-ASN	相关或疑问代名词，直接受词，单数，中性
Q-DSN	相关或疑问代名词，间接受格，单数，中性
Q-GPF	相关或疑问代名词，所有格，复数，阴性
Q-GPN	相关或疑问代名词，所有格，复数，中性
Q-NPF	相关或疑问代名词，主格，复数，阴性
Q-NPM	相关或疑问代名词，主格，复数，阳性
Q-NSM	相关或疑问代名词，主格，单数，阳性
Q-NSN	相关或疑问代名词，主格，单数，中性
R-APF	关系代名词，直接受词，复数，阴性
R-APM	关系代名词，直接受词，复数，阳性
R-APN	关系代名词，直接受词，复数，中性
R-ASF	关系代名词，直接受词，单数，阴性
R-ASM	关系代名词，直接受词，单数，阳性
R-ASM-P	关系代名词，直接受词，单数，阳性，附属质词
R-ASN	关系代名词，直接受词，单数，中性
R-DPF	关系代名词，间接受格，复数，阴性
R-DPM	关系代名词，间接受格，复数，阳性
R-DPN	关系代名词，间接受格，复数，中性
R-DSF	关系代名词，间接受格，单数，阴性
R-DSM	关系代名词，间接受格，单数，阳性
R-DSN	关系代名词，间接受格，单数，中性
R-GPF	关系代名词，所有格，复数，阴性
R-GPM	关系代名词，所有格，复数，阳性
R-GPN	关系代名词，所有格，复数，中性
R-GSF	关系代名词，所有格，单数，阴性
R-GSM	关系代名词，所有格，单数，阳性
R-GSN	关系代名词，所有格，单数，中性
R-GSN-ATT	关系代名词，所有格，单数，中性，阿提卡希腊语
R-NPF	关系代名词，主格，复数，阴性
R-NPM	关系代名词，主格，复数，阳性
R-NPN	关系代名词，主格，复数，中性
R-NSF	关系代名词，主格，单数，阴性
R-NSM	关系代名词，主格，单数，阳性
R-NSN	关系代名词，主格，单数，中性
S-1APF	所有代名词，第一人称，直接受词，复数，阴性
S-1APM	所有代名词，第一人称，直接受词，复数，阳性
S-1APN	所有代名词，第一人称，直接受词，复数，中性
S-1ASF	所有代名词，第一人称，直接受词，单数，阴性
S-1ASM	所有代名词，第一人称，直接受词，单数，阳性
S-1ASN	所有代名词，第一人称，直接受词，单数，中性
S-1DPF	所有代名词，第一人称，间接受格，复数，阴性
S-1DPM	所有代名词，第一人称，间接受格，复数，阳性
S-1DPN	所有代名词，第一人称，间接受格，复数，中性
S-1DSF	所有代名词，第一人称，间接受格，单数，阴性
S-1DSM	所有代名词，第一人称，间接受格，单数，阳性
S-1DSN	所有代名词，第一人称，间接受格，单数，中性
S-1GPF	所有代名词，第一人称，所有格，复数，阴性
S-1GPN	所有代名词，第一人称，所有格，复数，中性
S-1GSF	所有代名词，第一人称，所有格，单数，阴性
S-1NPF	所有代名词，第一人称，主格，复数，阴性
S-1NPM	所有代名词，第一人称，主格，复数，阳性
S-1NPN	所有代名词，第一人称，主格，复数，中性
S-1NSF	所有代名词，第一人称，主格，单数，阴性
S-1NSM	所有代名词，第一人称，主格，单数，阳性
S-1NSN	所有代名词，第一人称，主格，单数，中性
S-1PASF	所有代名词，第一人称，复数，直接受词，单数，阴性
S-1PASN	所有代名词，第一人称，复数，直接受词，单数，中性
S-1PDPF	所有代名词，第一人称，复数，间接受格，复数，阴性
S-1PDPM	所有代名词，第一人称，复数，间接受格，复数，阳性
S-1PGPF	所有代名词，第一人称，复数，所有格，复数，阴性
S-1PGSF	所有代名词，第一人称，复数，所有格，单数，阴性
S-1PNPM	所有代名词，第一人称，复数，主格，复数，阳性
S-1PNSF	所有代名词，第一人称，复数，主格，单数，阴性
S-1SAPF	所有代名词，第一人称，单数，直接受词，复数，阴性
S-1SAPM	所有代名词，第一人称，单数，直接受词，复数，阳性
S-1SAPN	所有代名词，第一人称，单数，直接受词，复数，中性
S-1SASF	所有代名词，第一人称，单数，直接受词，单数，阴性
S-1SASM	所有代名词，第一人称，单数，直接受词，单数，阳性
S-1SASN	所有代名词，第一人称，单数，直接受词，单数，中性
S-1SDPN	所有代名词，第一人称，单数，间接受格，复数，中性
S-1SDSF	所有代名词，第一人称，单数，间接受格，单数，阴性
S-1SDSM	所有代名词，第一人称，单数，间接受格，单数，阳性
S-1SDSN	所有代名词，第一人称，单数，间接受格，单数，中性
S-1SGPN	所有代名词，第一人称，单数，所有格，复数，中性
S-1SGSF	所有代名词，第一人称，单数，所有格，单数，阴性
S-1SGSN	所有代名词，第一人称，单数，所有格，单数，中性
S-1SNPM	所有代名词，第一人称，单数，主格，复数，阳性
S-1SNPN	所有代名词，第一人称，单数，主格，复数，中性
S-1SNSF	所有代名词，第一人称，单数，主格，单数，阴性
S-1SNSM	所有代名词，第一人称，单数，主格，单数，阳性
S-1SNSN	所有代名词，第一人称，单数，主格，单数，中性
S-2APF	所有代名词，第二人称，直接受词，复数，阴性
S-2APM	所有代名词，第二人称，直接受词，复数，阳性
S-2APN	所有代名词，第二人称，直接受词，复数，中性
S-2ASF	所有代名词，第二人称，直接受词，单数，阴性
S-2ASN	所有代名词，第二人称，直接受词，单数，中性
S-2DPF	所有代名词，第二人称，间接受格，复数，阴性
S-2DPM	所有代名词，第二人称，间接受格，复数，阳性
S-2DSF	所有代名词，第二人称，间接受格，单数，阴性
S-2DSM	所有代名词，第二人称，间接受格，单数，阳性
S-2GPF	所有代名词，第二人称，所有格，复数，阴性
S-2GSF	所有代名词，第二人称，所有格，单数，阴性
S-2NPF	所有代名词，第二人称，主格，复数，阴性
S-2NPM	所有代名词，第二人称，主格，复数，阳性
S-2NPN	所有代名词，第二人称，主格，复数，中性
S-2NSM	所有代名词，第二人称，主格，单数，阳性
S-2NSN	所有代名词，第二人称，主格，单数，中性
S-2PASF	所有代名词，第二人称，复数，直接受词，单数，阴性
S-2PASM	所有代名词，第二人称，复数，直接受词，单数，阳性
S-2PASN	所有代名词，第二人称，复数，直接受词，单数，中性
S-2PDSF	所有代名词，第二人称，复数，间接受格，单数，阴性
S-2PDSM	所有代名词，第二人称，复数，间接受格，单数，阳性
S-2PDSN	所有代名词，第二人称，复数，间接受格，单数，中性
S-2PGSF	所有代名词，第二人称，复数，所有格，单数，阴性
S-2PNSF	所有代名词，第二人称，复数，主格，单数，阴性
S-2PNSM	所有代名词，第二人称，复数，主格，单数，阳性
S-2SAPM	所有代名词，第二人称，单数，直接受词，复数，阳性
S-2SAPN	所有代名词，第二人称，单数，直接受词，复数，中性
S-2SASF	所有代名词，第二人称，单数，直接受词，单数，阴性
S-2SASN	所有代名词，第二人称，单数，直接受词，单数，中性
S-2SDSF	所有代名词，第二人称，单数，间接受格，单数，阴性
S-2SDSM	所有代名词，第二人称，单数，间接受格，单数，阳性
S-2SDSN	所有代名词，第二人称，单数，间接受格，单数，中性
S-2SGSF	所有代名词，第二人称，单数，所有格，单数，阴性
S-2SNPM	所有代名词，第二人称，单数，主格，复数，阳性
S-2SNPN	所有代名词，第二人称，单数，主格，复数，中性
S-2SNSM	所有代名词，第二人称，单数，主格，单数，阳性
S-2SNSN	所有代名词，第二人称，单数，主格，单数，中性
T-APF	冠词，直接受词，复数，阴性
T-APM	冠词，直接受词，复数，阳性
T-APN	冠词，直接受词，复数，中性
T-ASF	冠词，直接受词，单数，阴性
T-ASM	冠词，直接受词，单数，阳性
T-ASN	冠词，直接受词，单数，中性
T-DPF	冠词，间接受格，复数，阴性
T-DPM	冠词，间接受格，复数，阳性
T-DPN	冠词，间接受格，复数，中性
T-DSF	冠词，间接受格，单数，阴性
T-DSM	冠词，间接受格，单数，阳性
T-DSN	冠词，间接受格，单数，中性
T-GPF	冠词，所有格，复数，阴性
T-GPM	冠词，所有格，复数，阳性
T-GPN	冠词，所有格，复数，中性
T-GSF	冠词，所有格，单数，阴性
T-GSM	冠词，所有格，单数，阳性
T-GSN	冠词，所有格，单数，中性
T-NPF	冠词，主格，复数，阴性
T-NPM	冠词，主格，复数，阳性
T-NPN	冠词，主格，复数，中性
T-NSF	冠词，主格，单数，阴性
T-NSM	冠词，主格，单数，阳性
T-NSN	冠词，主格，单数，中性
T-VPF	冠词，呼格，复数，阴性
T-VPM	冠词，呼格，复数，阳性
T-VPN	冠词，呼格，复数，中性
T-VSF	冠词，呼格，单数，阴性
T-VSM	冠词，呼格，单数，阳性
T-VSN	冠词，呼格，单数，中性
V-2AAI-1P	动词，第二简单过去时态，主动，直说语气，第一人称，复数
V-2AAI-1S	动词，第二简单过去时态，主动，直说语气，第一人称，单数
V-2AAI-2P	动词，第二简单过去时态，主动，直说语气，第二人称，复数
V-2AAI-2S	动词，第二简单过去时态，主动，直说语气，第二人称，单数
V-2AAI-3P	动词，第二简单过去时态，主动，直说语气，第三人称，复数
V-2AAI-3P-ATT	动词，第二简单过去时态，主动，直说语气，第三人称，复数，阿提卡形式
V-2AAI-3S	动词，第二简单过去时态，主动，直说语气，第三人称，单数
V-2AAM-2P	动词，第二简单过去时态，主动，命令语气，第二人称，复数
V-2AAM-2S	动词，第二简单过去时态，主动，命令语气，第二人称，单数
V-2AAM-2S-AP	动词，第二简单过去时态，主动，命令语气，第二人称，单数，尾落形式
V-2AAM-2S-ATT	动词，第二简单过去时态，主动，命令语气，第二人称，单数，阿提卡形式
V-2AAM-3P	动词，第二简单过去时态，主动，命令语气，第三人称，复数
V-2AAM-3S	动词，第二简单过去时态，主动，命令语气，第三人称，单数
V-2AAN	动词，第二简单过去时态，主动，不定语气
V-2AAO-3P	动词，第二简单过去时态，主动，祈愿语气，第三人称，复数
V-2AAO-3S	动词，第二简单过去时态，主动，祈愿语气，第三人称，单数
V-2AAP-APF	动词，第二简单过去时态，主动，分词，直接受词，复数，阴性
V-2AAP-APM	动词，第二简单过去时态，主动，分词，直接受词，复数，阳性
V-2AAP-ASF	动词，第二简单过去时态，主动，分词，直接受词，单数，阴性
V-2AAP-ASM	动词，第二简单过去时态，主动，分词，直接受词，单数，阳性
V-2AAP-ASN	动词，第二简单过去时态，主动，分词，直接受词，单数，中性
V-2AAP-DPF	动词，第二简单过去时态，主动，分词，间接受格，复数，阴性
V-2AAP-DPM	动词，第二简单过去时态，主动，分词，间接受格，复数，阳性
V-2AAP-DSF	动词，第二简单过去时态，主动，分词，间接受格，单数，阴性
V-2AAP-DSM	动词，第二简单过去时态，主动，分词，间接受格，单数，阳性
V-2AAP-GPM	动词，第二简单过去时态，主动，分词，所有格，复数，阳性
V-2AAP-GSF	动词，第二简单过去时态，主动，分词，所有格，单数，阴性
V-2AAP-GSM	动词，第二简单过去时态，主动，分词，所有格，单数，阳性
V-2AAP-GSN	动词，第二简单过去时态，主动，分词，所有格，单数，中性
V-2AAP-NPF	动词，第二简单过去时态，主动，分词，主格，复数，阴性
V-2AAP-NPM	动词，第二简单过去时态，主动，分词，主格，复数，阳性
V-2AAP-NPN	动词，第二简单过去时态，主动，分词，主格，复数，中性
V-2AAP-NSF	动词，第二简单过去时态，主动，分词，主格，单数，阴性
V-2AAP-NSM	动词，第二简单过去时态，主动，分词，主格，单数，阳性
V-2AAP-NSN	动词，第二简单过去时态，主动，分词，主格，单数，中性
V-2AAS-1P	动词，第二简单过去时态，主动，假设语气，第一人称，复数
V-2AAS-1S	动词，第二简单过去时态，主动，假设语气，第一人称，单数
V-2AAS-2P	动词，第二简单过去时态，主动，假设语气，第二人称，复数
V-2AAS-2S	动词，第二简单过去时态，主动，假设语气，第二人称，单数
V-2AAS-3P	动词，第二简单过去时态，主动，假设语气，第三人称，复数
V-2AAS-3S	动词，第二简单过去时态，主动，假设语气，第三人称，单数
V-2ADI-1S	动词，第二简单过去时态，关身形主动意，直说语气，第一人称，单数
V-2ADI-2P	动词，第二简单过去时态，关身形主动意，直说语气，第二人称，复数
V-2ADI-2S	动词，第二简单过去时态，关身形主动意，直说语气，第二人称，单数
V-2ADI-3P	动词，第二简单过去时态，关身形主动意，直说语气，第三人称，复数
V-2ADI-3S	动词，第二简单过去时态，关身形主动意，直说语气，第三人称，单数
V-2ADM-2P	动词，第二简单过去时态，关身形主动意，命令语气，第二人称，复数
V-2ADM-2S	动词，第二简单过去时态，关身形主动意，命令语气，第二人称，单数
V-2ADM-3S	动词，第二简单过去时态，关身形主动意，命令语气，第三人称，单数
V-2ADN	动词，第二简单过去时态，关身形主动意，不定语气
V-2ADO-1S	动词，第二简单过去时态，关身形主动意，祈愿语气，第一人称，单数
V-2ADO-3S	动词，第二简单过去时态，关身形主动意，祈愿语气，第三人称，单数
V-2ADP-APM	动词，第二简单过去时态，关身形主动意，分词，直接受词，复数，阳性
V-2ADP-APN	动词，第二简单过去时态，关身形主动意，分词，直接受词，复数，中性
V-2ADP-ASF	动词，第二简单过去时态，关身形主动意，分词，直接受词，单数，阴性
V-2ADP-ASM	动词，第二简单过去时态，关身形主动意，分词，直接受词，单数，阳性
V-2ADP-ASN	动词，第二简单过去时态，关身形主动意，分词，直接受词，单数，中性
V-2ADP-DPM	动词，第二简单过去时态，关身形主动意，分词，间接受格，复数，阳性
V-2ADP-DPN	动词，第二简单过去时态，关身形主动意，分词，间接受格，复数，中性
V-2ADP-GPF	动词，第二简单过去时态，关身形主动意，分词，所有格，复数，阴性
V-2ADP-GPM	动词，第二简单过去时态，关身形主动意，分词，所有格，复数，阳性
V-2ADP-GPN	动词，第二简单过去时态，关身形主动意，分词，所有格，复数，中性
V-2ADP-GSF	动词，第二简单过去时态，关身形主动意，分词，所有格，单数，阴性
V-2ADP-GSM	动词，第二简单过去时态，关身形主动意，分词，所有格，单数，阳性
V-2ADP-GSN	动词，第二简单过去时态，关身形主动意，分词，所有格，单数，中性
V-2ADP-NPF	动词，第二简单过去时态，关身形主动意，分词，主格，复数，阴性
V-2ADP-NPM	动词，第二简单过去时态，关身形主动意，分词，主格，复数，阳性
V-2ADP-NSM	动词，第二简单过去时态，关身形主动意，分词，主格，单数，阳性
V-2ADS-1P	动词，第二简单过去时态，关身形主动意，假设语气，第一人称，复数
V-2ADS-1S	动词，第二简单过去时态，关身形主动意，假设语气，第一人称，单数
V-2ADS-2P	动词，第二简单过去时态，关身形主动意，假设语气，第二人称，复数
V-2ADS-3P	动词，第二简单过去时态，关身形主动意，假设语气，第三人称，复数
V-2ADS-3S	动词，第二简单过去时态，关身形主动意，假设语气，第三人称，单数
V-2AMI-1P	动词，第二简单过去时态，关身语态，直说语气，第一人称，复数
V-2AMI-1S	动词，第二简单过去时态，关身语态，直说语气，第一人称，单数
V-2AMI-2P	动词，第二简单过去时态，关身语态，直说语气，第二人称，复数
V-2AMI-2S	动词，第二简单过去时态，关身语态，直说语气，第二人称，单数
V-2AMI-3P	动词，第二简单过去时态，关身语态，直说语气，第三人称，复数
V-2AMI-3S	动词，第二简单过去时态，关身语态，直说语气，第三人称，单数
V-2AMM-2P	动词，第二简单过去时态，关身语态，命令语气，第二人称，复数
V-2AMM-2S	动词，第二简单过去时态，关身语态，命令语气，第二人称，单数
V-2AMN	动词，第二简单过去时态，关身语态，不定语气
V-2AMP-GSM	动词，第二简单过去时态，关身语态，分词，所有格，单数，阳性
V-2AMP-NPM	动词，第二简单过去时态，关身语态，分词，主格，复数，阳性
V-2AMP-NSM	动词，第二简单过去时态，关身语态，分词，主格，单数，阳性
V-2AMS-1P	动词，第二简单过去时态，关身语态，假设语气，第一人称，复数
V-2AMS-1S	动词，第二简单过去时态，关身语态，假设语气，第一人称，单数
V-2AMS-2S	动词，第二简单过去时态，关身语态，假设语气，第二人称，单数
V-2AMS-3P	动词，第二简单过去时态，关身语态，假设语气，第三人称，复数
V-2AMS-3S	动词，第二简单过去时态，关身语态，假设语气，第三人称，单数
V-2AOI-1P	动词，第二简单过去时态，被动形主动意，直说语气，第一人称，复数
V-2AOI-1S	动词，第二简单过去时态，被动形主动意，直说语气，第一人称，单数
V-2AOI-2P	动词，第二简单过去时态，被动形主动意，直说语气，第二人称，复数
V-2AOI-3P	动词，第二简单过去时态，被动形主动意，直说语气，第三人称，复数
V-2AOI-3S	动词，第二简单过去时态，被动形主动意，直说语气，第三人称，单数
V-2AOM-2P	动词，第二简单过去时态，被动形主动意，命令语气，第二人称，复数
V-2AON	动词，第二简单过去时态，被动形主动意，不定语气
V-2AOS-2P	动词，第二简单过去时态，被动形主动意，假设语气，第二人称，复数
V-2API-1P	动词，第二简单过去时态，被动语态，直说语气，第一人称，复数
V-2API-1S	动词，第二简单过去时态，被动语态，直说语气，第一人称，单数
V-2API-2P	动词，第二简单过去时态，被动语态，直说语气，第二人称，复数
V-2API-2S	动词，第二简单过去时态，被动语态，直说语气，第二人称，单数
V-2API-3P	动词，第二简单过去时态，被动语态，直说语气，第三人称，复数
V-2API-3S	动词，第二简单过去时态，被动语态，直说语气，第三人称，单数
V-2APM-2P	动词，第二简单过去时态，被动语态，命令语气，第二人称，复数
V-2APM-2S	动词，第二简单过去时态，被动语态，命令语气，第二人称，单数
V-2APM-3S	动词，第二简单过去时态，被动语态，命令语气，第三人称，单数
V-2APN	动词，第二简单过去时态，被动语态，不定语气
V-2APP-ASM	动词，第二简单过去时态，被动语态，分词，直接受词，单数，阳性
V-2APP-DSN	动词，第二简单过去时态，被动语态，分词，间接受格，单数，中性
V-2APP-GPM	动词，第二简单过去时态，被动语态，分词，所有格，复数，阳性
V-2APP-NPF	动词，第二简单过去时态，被动语态，分词，主格，复数，阴性
V-2APP-NPM	动词，第二简单过去时态，被动语态，分词，主格，复数，阳性
V-2APP-NSF	动词，第二简单过去时态，被动语态，分词，主格，单数，阴性
V-2APP-NSM	动词，第二简单过去时态，被动语态，分词，主格，单数，阳性
V-2APP-NSN	动词，第二简单过去时态，被动语态，分词，主格，单数，中性
V-2APS-1P	动词，第二简单过去时态，被动语态，假设语气，第一人称，复数
V-2APS-2P	动词，第二简单过去时态，被动语态，假设语气，第二人称，复数
V-2APS-2S	动词，第二简单过去时态，被动语态，假设语气，第二人称，单数
V-2APS-3P	动词，第二简单过去时态，被动语态，假设语气，第三人称，复数
V-2APS-3S	动词，第二简单过去时态，被动语态，假设语气，第三人称，单数
V-2AXM-2P	动词，第二简单过去时态，无指定语态，命令语气，第二人称，复数
V-2AXP-GPM	动词，第二简单过去时态，无指定语态，分词，所有格，复数，阳性
V-2AXS-2P	动词，第二简单过去时态，无指定语态，假设语气，第二人称，复数
V-2FAI-1S	动词，第二未来时态，主动，直说语气，第一人称，单数
V-2FAI-3S	动词，第二未来时态，主动，直说语气，第三人称，单数
V-2FDI-2S	动词，第二未来时态，关身形主动意，直说语气，第二人称，单数
V-2FDI-3P	动词，第二未来时态，关身形主动意，直说语气，第三人称，复数
V-2FDI-3S	动词，第二未来时态，关身形主动意，直说语气，第三人称，单数
V-2FMI-3S	动词，第二未来时态，关身语态，直说语气，第三人称，单数
V-2FOI-1S	动词，第二未来时态，被动形主动意，直说语气，第一人称，单数
V-2FOI-3P	动词，第二未来时态，被动形主动意，直说语气，第三人称，复数
V-2FOI-3S	动词，第二未来时态，被动形主动意，直说语气，第三人称，单数
V-2FPI-1P	动词，第二未来时态，被动语态，直说语气，第一人称，复数
V-2FPI-2P	动词，第二未来时态，被动语态，直说语气，第二人称，复数
V-2FPI-2S	动词，第二未来时态，被动语态，直说语气，第二人称，单数
V-2FPI-3P	动词，第二未来时态，被动语态，直说语气，第三人称，复数
V-2FPI-3S	动词，第二未来时态，被动语态，直说语气，第三人称，单数
V-2LAI-1S	动词，第二过去完成时态，主动，直说语气，第一人称，单数
V-2LAI-2P	动词，第二过去完成时态，主动，直说语气，第二人称，复数
V-2LAI-2S	动词，第二过去完成时态，主动，直说语气，第二人称，单数
V-2LAI-3P	动词，第二过去完成时态，主动，直说语气，第三人称，复数
V-2LAI-3S	动词，第二过去完成时态，主动，直说语气，第三人称，单数
V-2PAI-2S	动词，第二现在进行时态，主动，直说语气，第二人称，单数
V-2PAN	动词，第二现在进行时态，主动，不定语气
V-2RAI-1P	动词，第二现在完成时态，主动，直说语气，第一人称，复数
V-2RAI-1P-ATT	动词，第二现在完成时态，主动，直说语气，第一人称，复数，阿提卡形式
V-2RAI-1S	动词，第二现在完成时态，主动，直说语气，第一人称，单数
V-2RAI-2P	动词，第二现在完成时态，主动，直说语气，第二人称，复数
V-2RAI-2P-ATT	动词，第二现在完成时态，主动，直说语气，第二人称，复数，阿提卡形式
V-2RAI-2S	动词，第二现在完成时态，主动，直说语气，第二人称，单数
V-2RAI-3P	动词，第二现在完成时态，主动，直说语气，第三人称，复数
V-2RAI-3P-ATT	动词，第二现在完成时态，主动，直说语气，第三人称，复数，阿提卡形式
V-2RAI-3P-C	动词，第二现在完成时态，主动，直说语气，第三人称，复数，缩略形式
V-2RAI-3S	动词，第二现在完成时态，主动，直说语气，第三人称，单数
V-2RAI-3S-ATT	动词，第二现在完成时态，主动，直说语气，第三人称，单数，阿提卡形式
V-2RAN	动词，第二现在完成时态，主动，不定语气
V-2RAP-APM	动词，第二现在完成时态，主动，分词，直接受词，复数，阳性
V-2RAP-APM-ATT	动词，第二现在完成时态，主动，分词，直接受词，复数，阳性，阿提卡形式
V-2RAP-APN	动词，第二现在完成时态，主动，分词，直接受词，复数，中性
V-2RAP-ASF	动词，第二现在完成时态，主动，分词，直接受词，单数，阴性
V-2RAP-ASM	动词，第二现在完成时态，主动，分词，直接受词，单数，阳性
V-2RAP-ASN	动词，第二现在完成时态，主动，分词，直接受词，单数，中性
V-2RAP-DSN	动词，第二现在完成时态，主动，分词，间接受格，单数，中性
V-2RAP-GPN	动词，第二现在完成时态，主动，分词，所有格，复数，中性
V-2RAP-NPF	动词，第二现在完成时态，主动，分词，主格，复数，阴性
V-2RAP-NPM	动词，第二现在完成时态，主动，分词，主格，复数，阳性
V-2RAP-NSF	动词，第二现在完成时态，主动，分词，主格，单数，阴性
V-2RAP-NSM	动词，第二现在完成时态，主动，分词，主格，单数，阳性
V-2RAP-NSN	动词，第二现在完成时态，主动，分词，主格，单数，中性
V-2RPP-APF	动词，第二现在完成时态，被动语态，分词，直接受词，复数，阴性
V-2RPP-ASM	动词，第二现在完成时态，被动语态，分词，直接受词，单数，阳性
V-2RPP-ASN	动词，第二现在完成时态，被动语态，分词，直接受词，单数，中性
V-2RPP-GSF	动词，第二现在完成时态，被动语态，分词，所有格，单数，阴性
V-2RPP-NSM	动词，第二现在完成时态，被动语态，分词，主格，单数，阳性
V-AAI-1P	动词，简单过去时态，主动，直说语气，第一人称，复数
V-AAI-1S	动词，简单过去时态，主动，直说语气，第一人称，单数
V-AAI-2P	动词，简单过去时态，主动，直说语气，第二人称，复数
V-AAI-2S	动词，简单过去时态，主动，直说语气，第二人称，单数
V-AAI-3P	动词，简单过去时态，主动，直说语气，第三人称，复数
V-AAI-3S	动词，简单过去时态，主动，直说语气，第三人称，单数
V-AAM-2P	动词，简单过去时态，主动，命令语气，第二人称，复数
V-AAM-2S	动词，简单过去时态，主动，命令语气，第二人称，单数
V-AAM-3P	动词，简单过去时态，主动，命令语气，第三人称，复数
V-AAM-3S	动词，简单过去时态，主动，命令语气，第三人称，单数
V-AAN	动词，简单过去时态，主动，不定语气
V-AAO-3P	动词，简单过去时态，主动，祈愿语气，第三人称，复数
V-AAO-3P-A	动词，简单过去时态，主动，祈愿语气，第三人称，复数，伊欧里斯希腊语
V-AAO-3S	动词，简单过去时态，主动，祈愿语气，第三人称，单数
V-AAP-APM	动词，简单过去时态，主动，分词，直接受词，复数，阳性
V-AAP-APN	动词，简单过去时态，主动，分词，直接受词，复数，中性
V-AAP-ASF	动词，简单过去时态，主动，分词，直接受词，单数，阴性
V-AAP-ASM	动词，简单过去时态，主动，分词，直接受词，单数，阳性
V-AAP-ASN	动词，简单过去时态，主动，分词，直接受词，单数，中性
V-AAP-DPM	动词，简单过去时态，主动，分词，间接受格，复数，阳性
V-AAP-DSM	动词，简单过去时态，主动，分词，间接受格，单数，阳性
V-AAP-GPM	动词，简单过去时态，主动，分词，所有格，复数，阳性
V-AAP-GSF	动词，简单过去时态，主动，分词，所有格，单数，阴性
V-AAP-GSM	动词，简单过去时态，主动，分词，所有格，单数，阳性
V-AAP-NPF	动词，简单过去时态，主动，分词，主格，复数，阴性
V-AAP-NPM	动词，简单过去时态，主动，分词，主格，复数，阳性
V-AAP-NSF	动词，简单过去时态，主动，分词，主格，单数，阴性
V-AAP-NSM	动词，简单过去时态，主动，分词，主格，单数，阳性
V-AAP-NSN	动词，简单过去时态，主动，分词，主格，单数，中性
V-AAPNS	动词，简单过去时态，主动，分词，主格，单数
V-AAS-1P	动词，简单过去时态，主动，假设语气，第一人称，复数
V-AAS-1S	动词，简单过去时态，主动，假设语气，第一人称，单数
V-AAS-2P	动词，简单过去时态，主动，假设语气，第二人称，复数
V-AAS-2S	动词，简单过去时态，主动，假设语气，第二人称，单数
V-AAS-3P	动词，简单过去时态，主动，假设语气，第三人称，复数
V-AAS-3S	动词，简单过去时态，主动，假设语气，第三人称，单数
V-ADI-1P	动词，简单过去时态，关身形主动意，直说语气，第一人称，复数
V-ADI-1S	动词，简单过去时态，关身形主动意，直说语气，第一人称，单数
V-ADI-2P	动词，简单过去时态，关身形主动意，直说语气，第二人称，复数
V-ADI-2S	动词，简单过去时态，关身形主动意，直说语气，第二人称，单数
V-ADI-3P	动词，简单过去时态，关身形主动意，直说语气，第三人称，复数
V-ADI-3S	动词，简单过去时态，关身形主动意，直说语气，第三人称，单数
V-ADM-2P	动词，简单过去时态，关身形主动意，命令语气，第二人称，复数
V-ADM-2S	动词，简单过去时态，关身形主动意，命令语气，第二人称，单数
V-ADM-3P	动词，简单过去时态，关身形主动意，命令语气，第三人称，复数
V-ADM-3S	动词，简单过去时态，关身形主动意，命令语气，第三人称，单数
V-ADN	动词，简单过去时态，关身形主动意，不定语气
V-ADO-1S	动词，简单过去时态，关身形主动意，祈愿语气，第一人称，单数
V-ADP-APM	动词，简单过去时态，关身形主动意，分词，直接受词，复数，阳性
V-ADP-ASM	动词，简单过去时态，关身形主动意，分词，直接受词，单数，阳性
V-ADP-DPM	动词，简单过去时态，关身形主动意，分词，间接受格，复数，阳性
V-ADP-GSF	动词，简单过去时态，关身形主动意，分词，所有格，单数，阴性
V-ADP-NPM	动词，简单过去时态，关身形主动意，分词，主格，复数，阳性
V-ADP-NSF	动词，简单过去时态，关身形主动意，分词，主格，单数，阴性
V-ADP-NSM	动词，简单过去时态，关身形主动意，分词，主格，单数，阳性
V-ADS-1P	动词，简单过去时态，关身形主动意，假设语气，第一人称，复数
V-ADS-1S	动词，简单过去时态，关身形主动意，假设语气，第一人称，单数
V-ADS-2P	动词，简单过去时态，关身形主动意，假设语气，第二人称，复数
V-ADS-2S	动词，简单过去时态，关身形主动意，假设语气，第二人称，单数
V-ADS-3P	动词，简单过去时态，关身形主动意，假设语气，第三人称，复数
V-ADS-3S	动词，简单过去时态，关身形主动意，假设语气，第三人称，单数
V-AMI-1P	动词，简单过去时态，关身语态，直说语气，第一人称，复数
V-AMI-1S	动词，简单过去时态，关身语态，直说语气，第一人称，单数
V-AMI-2P	动词，简单过去时态，关身语态，直说语气，第二人称，复数
V-AMI-2S	动词，简单过去时态，关身语态，直说语气，第二人称，单数
V-AMI-3P	动词，简单过去时态，关身语态，直说语气，第三人称，复数
V-AMI-3S	动词，简单过去时态，关身语态，直说语气，第三人称，单数
V-AMM-2P	动词，简单过去时态，关身语态，命令语气，第二人称，复数
V-AMM-2S	动词，简单过去时态，关身语态，命令语气，第二人称，单数
V-AMM-3S	动词，简单过去时态，关身语态，命令语气，第三人称，单数
V-AMN	动词，简单过去时态，关身语态，不定语气
V-AMP-APM	动词，简单过去时态，关身语态，分词，直接受词，复数，阳性
V-AMP-ASN	动词，简单过去时态，关身语态，分词，直接受词，单数，中性
V-AMP-DPM	动词，简单过去时态，关身语态，分词，间接受格，复数，阳性
V-AMP-GPM	动词，简单过去时态，关身语态，分词，所有格，复数，阳性
V-AMP-GSM	动词，简单过去时态，关身语态，分词，所有格，单数，阳性
V-AMP-NPM	动词，简单过去时态，关身语态，分词，主格，复数，阳性
V-AMP-NSF	动词，简单过去时态，关身语态，分词，主格，单数，阴性
V-AMP-NSM	动词，简单过去时态，关身语态，分词，主格，单数，阳性
V-AMP-NSN	动词，简单过去时态，关身语态，分词，主格，单数，中性
V-AMPNP	动词，简单过去时态，关身语态，分词，主格，复数
V-AMS-1P	动词，简单过去时态，关身语态，假设语气，第一人称，复数
V-AMS-1S	动词，简单过去时态，关身语态，假设语气，第一人称，单数
V-AMS-2P	动词，简单过去时态，关身语态，假设语气，第二人称，复数
V-AMS-2S	动词，简单过去时态，关身语态，假设语气，第二人称，单数
V-AMS-3P	动词，简单过去时态，关身语态，假设语气，第三人称，复数
V-AMS-3S	动词，简单过去时态，关身语态，假设语气，第三人称，单数
V-ANI-3P	动词，简单过去时态，关身形或被动形主动意，直说语气，第三人称，复数
V-ANI-3S	动词，简单过去时态，关身形或被动形主动意，直说语气，第三人称，单数
V-ANP-NSM	动词，简单过去时态，关身形或被动形主动意，分词，主格，单数，阳性
V-ANP-NSN	动词，简单过去时态，关身形或被动形主动意，分词，主格，单数，中性
V-AOI-1P	动词，简单过去时态，被动形主动意，直说语气，第一人称，复数
V-AOI-1P-ATT	动词，简单过去时态，被动形主动意，直说语气，第一人称，复数，阿提卡形式
V-AOI-1S	动词，简单过去时态，被动形主动意，直说语气，第一人称，单数
V-AOI-1S-ATT	动词，简单过去时态，被动形主动意，直说语气，第一人称，单数，阿提卡形式
V-AOI-2P	动词，简单过去时态，被动形主动意，直说语气，第二人称，复数
V-AOI-2P-ATT	动词，简单过去时态，被动形主动意，直说语气，第二人称，复数，阿提卡形式
V-AOI-3P	动词，简单过去时态，被动形主动意，直说语气，第三人称，复数
V-AOI-3P-ATT	动词，简单过去时态，被动形主动意，直说语气，第三人称，复数，阿提卡形式
V-AOI-3S	动词，简单过去时态，被动形主动意，直说语气，第三人称，单数
V-AOI-3S-ATT	动词，简单过去时态，被动形主动意，直说语气，第三人称，单数，阿提卡形式
V-AOM-2P	动词，简单过去时态，被动形主动意，命令语气，第二人称，复数
V-AOM-2S	动词，简单过去时态，被动形主动意，命令语气，第二人称，单数
V-AOM-3S	动词，简单过去时态，被动形主动意，命令语气，第三人称，单数
V-AON	动词，简单过去时态，被动形主动意，不定语气
V-AOO-3S	动词，简单过去时态，被动形主动意，祈愿语气，第三人称，单数
V-AOP-APM	动词，简单过去时态，被动形主动意，分词，直接受词，复数，阳性
V-AOP-ASM	动词，简单过去时态，被动形主动意，分词，直接受词，单数，阳性
V-AOP-DSM	动词，简单过去时态，被动形主动意，分词，间接受格，单数，阳性
V-AOP-GPM	动词，简单过去时态，被动形主动意，分词，所有格，复数，阳性
V-AOP-GPN	动词，简单过去时态，被动形主动意，分词，所有格，复数，中性
V-AOP-GSM	动词，简单过去时态，被动形主动意，分词，所有格，单数，阳性
V-AOP-NPF	动词，简单过去时态，被动形主动意，分词，主格，复数，阴性
V-AOP-NPM	动词，简单过去时态，被动形主动意，分词，主格，复数，阳性
V-AOP-NSF	动词，简单过去时态，被动形主动意，分词，主格，单数，阴性
V-AOP-NSM	动词，简单过去时态，被动形主动意，分词，主格，单数，阳性
V-AOP-NSN	动词，简单过去时态，被动形主动意，分词，主格，单数，中性
V-AOS-1P	动词，简单过去时态，被动形主动意，假设语气，第一人称，复数
V-AOS-1S	动词，简单过去时态，被动形主动意，假设语气，第一人称，单数
V-AOS-2P	动词，简单过去时态，被动形主动意，假设语气，第二人称，复数
V-AOS-2S	动词，简单过去时态，被动形主动意，假设语气，第二人称，单数
V-AOS-3P	动词，简单过去时态，被动形主动意，假设语气，第三人称，复数
V-AOS-3S	动词，简单过去时态，被动形主动意，假设语气，第三人称，单数
V-API	动词，简单过去时态，被动语态，直说语气
V-API-1P	动词，简单过去时态，被动语态，直说语气，第一人称，复数
V-API-1S	动词，简单过去时态，被动语态，直说语气，第一人称，单数
V-API-2P	动词，简单过去时态，被动语态，直说语气，第二人称，复数
V-API-2S	动词，简单过去时态，被动语态，直说语气，第二人称，单数
V-API-3P	动词，简单过去时态，被动语态，直说语气，第三人称，复数
V-API-3S	动词，简单过去时态，被动语态，直说语气，第三人称，单数
V-API-3S-M	动词，简单过去时态，被动语态，直说语气，第三人称，单数，关身意义
V-APM-2P	动词，简单过去时态，被动语态，命令语气，第二人称，复数
V-APM-2S	动词，简单过去时态，被动语态，命令语气，第二人称，单数
V-APM-3P	动词，简单过去时态，被动语态，命令语气，第三人称，复数
V-APM-3S	动词，简单过去时态，被动语态，命令语气，第三人称，单数
V-APN	动词，简单过去时态，被动语态，不定语气
V-APN-M	动词，简单过去时态，被动语态，不定语气，阳性
V-APO-3S	动词，简单过去时态，被动语态，祈愿语气，第三人称，单数
V-APP-APM	动词，简单过去时态，被动语态，分词，直接受词，复数，阳性
V-APP-APN	动词，简单过去时态，被动语态，分词，直接受词，复数，中性
V-APP-ASF	动词，简单过去时态，被动语态，分词，直接受词，单数，阴性
V-APP-ASM	动词，简单过去时态，被动语态，分词，直接受词，单数，阳性
V-APP-ASN	动词，简单过去时态，被动语态，分词，直接受词，单数，中性
V-APP-DPN	动词，简单过去时态，被动语态，分词，间接受格，复数，中性
V-APP-DSF	动词，简单过去时态，被动语态，分词，间接受格，单数，阴性
V-APP-DSM	动词，简单过去时态，被动语态，分词，间接受格，单数，阳性
V-APP-GPF	动词，简单过去时态，被动语态，分词，所有格，复数，阴性
V-APP-GPM	动词，简单过去时态，被动语态，分词，所有格，复数，阳性
V-APP-GPN	动词，简单过去时态，被动语态，分词，所有格，复数，中性
V-APP-GSF	动词，简单过去时态，被动语态，分词，所有格，单数，阴性
V-APP-GSM	动词，简单过去时态，被动语态，分词，所有格，单数，阳性
V-APP-GSN	动词，简单过去时态，被动语态，分词，所有格，单数，中性
V-APP-NPM	动词，简单过去时态，被动语态，分词，主格，复数，阳性
V-APP-NPN	动词，简单过去时态，被动语态，分词，主格，复数，中性
V-APP-NSF	动词，简单过去时态，被动语态，分词，主格，单数，阴性
V-APP-NSM	动词，简单过去时态，被动语态，分词，主格，单数，阳性
V-APP-NSM-M	动词，简单过去时态，被动语态，分词，主格，单数，阳性，关身意义
V-APP-NSN	动词，简单过去时态，被动语态，分词，主格，单数，中性
V-APS-1P	动词，简单过去时态，被动语态，假设语气，第一人称，复数
V-APS-1S	动词，简单过去时态，被动语态，假设语气，第一人称，单数
V-APS-2P	动词，简单过去时态，被动语态，假设语气，第二人称，复数
V-APS-2S	动词，简单过去时态，被动语态，假设语气，第二人称，单数
V-APS-3P	动词，简单过去时态，被动语态，假设语气，第三人称，复数
V-APS-3S	动词，简单过去时态，被动语态，假设语气，第三人称，单数
V-FAI-1P	动词，未来时态，主动，直说语气，第一人称，复数
V-FAI-1S	动词，未来时态，主动，直说语气，第一人称，单数
V-FAI-1S-ATT	动词，未来时态，主动，直说语气，第一人称，单数，阿提卡形式
V-FAI-2P	动词，未来时态，主动，直说语气，第二人称，复数
V-FAI-2S	动词，未来时态，主动，直说语气，第二人称，单数
V-FAI-3P	动词，未来时态，主动，直说语气，第三人称，复数
V-FAI-3P-ATT	动词，未来时态，主动，直说语气，第三人称，复数，阿提卡形式
V-FAI-3S	动词，未来时态，主动，直说语气，第三人称，单数
V-FAI-3S-ATT	动词，未来时态，主动，直说语气，第三人称，单数，阿提卡形式
V-FAN	动词，未来时态，主动，不定语气
V-FAP-APN	动词，未来时态，主动，分词，直接受词，复数，中性
V-FAP-GPM	动词，未来时态，主动，分词，所有格，复数，阳性
V-FAP-NPM	动词，未来时态，主动，分词，主格，复数，阳性
V-FAP-NSM	动词，未来时态，主动，分词，主格，单数，阳性
V-FDI-1P	动词，未来时态，关身形主动意，直说语气，第一人称，复数
V-FDI-1S	动词，未来时态，关身形主动意，直说语气，第一人称，单数
V-FDI-2P	动词，未来时态，关身形主动意，直说语气，第二人称，复数
V-FDI-2P-ATT	动词，未来时态，关身形主动意，直说语气，第二人称，复数，阿提卡形式
V-FDI-2S	动词，未来时态，关身形主动意，直说语气，第二人称，单数
V-FDI-2S-ATT	动词，未来时态，关身形主动意，直说语气，第二人称，单数，阿提卡形式
V-FDI-3P	动词，未来时态，关身形主动意，直说语气，第三人称，复数
V-FDI-3S	动词，未来时态，关身形主动意，直说语气，第三人称，单数
V-FDI-3S-ATT	动词，未来时态，关身形主动意，直说语气，第三人称，单数，阿提卡形式
V-FDN	动词，未来时态，关身形主动意，不定语气
V-FDP-ASN	动词，未来时态，关身形主动意，分词，直接受词，单数，中性
V-FDP-NPM	动词，未来时态，关身形主动意，分词，主格，复数，阳性
V-FMI-1P	动词，未来时态，关身语态，直说语气，第一人称，复数
V-FMI-1S	动词，未来时态，关身语态，直说语气，第一人称，单数
V-FMI-2P	动词，未来时态，关身语态，直说语气，第二人称，复数
V-FMI-2S	动词，未来时态，关身语态，直说语气，第二人称，单数
V-FMI-3P	动词，未来时态，关身语态，直说语气，第三人称，复数
V-FMI-3S	动词，未来时态，关身语态，直说语气，第三人称，单数
V-FNI-3P	动词，未来时态，关身形或被动形主动意，直说语气，第三人称，复数
V-FNI-3S	动词，未来时态，关身形或被动形主动意，直说语气，第三人称，单数
V-FOI-1S	动词，未来时态，被动形主动意，直说语气，第一人称，单数
V-FOI-3P	动词，未来时态，被动形主动意，直说语气，第三人称，复数
V-FOI-3S	动词，未来时态，被动形主动意，直说语气，第三人称，单数
V-FPI-1P	动词，未来时态，被动语态，直说语气，第一人称，复数
V-FPI-1S	动词，未来时态，被动语态，直说语气，第一人称，单数
V-FPI-2P	动词，未来时态，被动语态，直说语气，第二人称，复数
V-FPI-2S	动词，未来时态，被动语态，直说语气，第二人称，单数
V-FPI-3P	动词，未来时态，被动语态，直说语气，第三人称，复数
V-FPI-3S	动词，未来时态，被动语态，直说语气，第三人称，单数
V-FPP-GPN	动词，未来时态，被动语态，分词，所有格，复数，中性
V-FPS-1S	动词，未来时态，被动语态，假设语气，第一人称，单数
V-FXI-1P	动词，未来时态，无指定语态，直说语气，第一人称，复数
V-FXI-1S	动词，未来时态，无指定语态，直说语气，第一人称，单数
V-FXI-2P	动词，未来时态，无指定语态，直说语气，第二人称，复数
V-FXI-2S	动词，未来时态，无指定语态，直说语气，第二人称，单数
V-FXI-3P	动词，未来时态，无指定语态，直说语气，第三人称，复数
V-FXI-3S	动词，未来时态，无指定语态，直说语气，第三人称，单数
V-FXN	动词，未来时态，无指定语态，不定语气
V-FXP-ASN	动词，未来时态，无指定语态，分词，直接受词，单数，中性
V-FXP-NSM	动词，未来时态，无指定语态，分词，主格，单数，阳性
V-IAI-1P	动词，过去不完成时态，主动，直说语气，第一人称，复数
V-IAI-1S	动词，过去不完成时态，主动，直说语气，第一人称，单数
V-IAI-1S-ATT	动词，过去不完成时态，主动，直说语气，第一人称，单数，阿提卡形式
V-IAI-2P	动词，过去不完成时态，主动，直说语气，第二人称，复数
V-IAI-2S	动词，过去不完成时态，主动，直说语气，第二人称，单数
V-IAI-3P	动词，过去不完成时态，主动，直说语气，第三人称，复数
V-IAI-3P-ATT	动词，过去不完成时态，主动，直说语气，第三人称，复数，阿提卡形式
V-IAI-3S	动词，过去不完成时态，主动，直说语气，第三人称，单数
V-IAI-3S-ATT	动词，过去不完成时态，主动，直说语气，第三人称，单数，阿提卡形式
V-IDI-3P	动词，过去不完成时态，关身形主动意，直说语气，第三人称，复数
V-IEI-3S	动词，过去不完成时态，关身或被动语态，直说语气，第三人称，单数
V-IMI-1P	动词，过去不完成时态，关身语态，直说语气，第一人称，复数
V-IMI-1S	动词，过去不完成时态，关身语态，直说语气，第一人称，单数
V-IMI-2P	动词，过去不完成时态，关身语态，直说语气，第二人称，复数
V-IMI-2S	动词，过去不完成时态，关身语态，直说语气，第二人称，单数
V-IMI-3P	动词，过去不完成时态，关身语态，直说语气，第三人称，复数
V-IMI-3S	动词，过去不完成时态，关身语态，直说语气，第三人称，单数
V-INI-1P	动词，过去不完成时态，关身形或被动形主动意，直说语气，第一人称，复数
V-INI-1S	动词，过去不完成时态，关身形或被动形主动意，直说语气，第一人称，单数
V-INI-2P	动词，过去不完成时态，关身形或被动形主动意，直说语气，第二人称，复数
V-INI-2P-ATT	动词，过去不完成时态，关身形或被动形主动意，直说语气，第二人称，复数，阿提卡形式
V-INI-2S	动词，过去不完成时态，关身形或被动形主动意，直说语气，第二人称，单数
V-INI-3P	动词，过去不完成时态，关身形或被动形主动意，直说语气，第三人称，复数
V-INI-3P-ATT	动词，过去不完成时态，关身形或被动形主动意，直说语气，第三人称，复数，阿提卡形式
V-INI-3S	动词，过去不完成时态，关身形或被动形主动意，直说语气，第三人称，单数
V-INI-3S-ATT	动词，过去不完成时态，关身形或被动形主动意，直说语气，第三人称，单数，阿提卡形式
V-IPI-1P	动词，过去不完成时态，被动语态，直说语气，第一人称，复数
V-IPI-1S	动词，过去不完成时态，被动语态，直说语气，第一人称，单数
V-IPI-2P	动词，过去不完成时态，被动语态，直说语气，第二人称，复数
V-IPI-3P	动词，过去不完成时态，被动语态，直说语气，第三人称，复数
V-IPI-3S	动词，过去不完成时态，被动语态，直说语气，第三人称，单数
V-IQI-3S	动词，过去不完成时态，非人格主动，直说语气，第三人称，单数
V-IXI-1P	动词，过去不完成时态，无指定语态，直说语气，第一人称，复数
V-IXI-1S	动词，过去不完成时态，无指定语态，直说语气，第一人称，单数
V-IXI-2P	动词，过去不完成时态，无指定语态，直说语气，第二人称，复数
V-IXI-2S	动词，过去不完成时态，无指定语态，直说语气，第二人称，单数
V-IXI-3P	动词，过去不完成时态，无指定语态，直说语气，第三人称，复数
V-IXI-3S	动词，过去不完成时态，无指定语态，直说语气，第三人称，单数
V-LAI-1S	动词，过去完成时态，主动，直说语气，第一人称，单数
V-LAI-2P	动词，过去完成时态，主动，直说语气，第二人称，复数
V-LAI-2S	动词，过去完成时态，主动，直说语气，第二人称，单数
V-LAI-3P	动词，过去完成时态，主动，直说语气，第三人称，复数
V-LAI-3P-ATT	动词，过去完成时态，主动，直说语气，第三人称，复数，阿提卡形式
V-LAI-3S	动词，过去完成时态，主动，直说语气，第三人称，单数
V-LAI-3S-ATT	动词，过去完成时态，主动，直说语气，第三人称，单数，阿提卡形式
V-LDI-3S	动词，过去完成时态，关身形主动意，直说语气，第三人称，单数
V-LMI-3P	动词，过去完成时态，关身语态，直说语气，第三人称，复数
V-LPI-3S	动词，过去完成时态，被动语态，直说语气，第三人称，单数
V-PAI-1P	动词，现在进行时态，主动，直说语气，第一人称，复数
V-PAI-1S	动词，现在进行时态，主动，直说语气，第一人称，单数
V-PAI-1S-C	动词，现在进行时态，主动，直说语气，第一人称，单数，缩略形式
V-PAI-2P	动词，现在进行时态，主动，直说语气，第二人称，复数
V-PAI-2S	动词，现在进行时态，主动，直说语气，第二人称，单数
V-PAI-2S-IRR	动词，现在进行时态，主动，直说语气，第二人称，单数，不规则形式
V-PAI-3P	动词，现在进行时态，主动，直说语气，第三人称，复数
V-PAI-3P (V-PAP-DPM)	动词，现在进行时态，主动，直说语气，第三人称，复数；动词，现在进行时态，主动，分词，间接受格，复数，阳性
V-PAI-3P-ATT	动词，现在进行时态，主动，直说语气，第三人称，复数，阿提卡形式
V-PAI-3S	动词，现在进行时态，主动，直说语气，第三人称，单数
V-PAM-2P	动词，现在进行时态，主动，命令语气，第二人称，复数
V-PAM-2S	动词，现在进行时态，主动，命令语气，第二人称，单数
V-PAM-3P	动词，现在进行时态，主动，命令语气，第三人称，复数
V-PAM-3S	动词，现在进行时态，主动，命令语气，第三人称，单数
V-PAN	动词，现在进行时态，主动，不定语气
V-PAO-2P	动词，现在进行时态，主动，祈愿语气，第二人称，复数
V-PAO-3P	动词，现在进行时态，主动，祈愿语气，第三人称，复数
V-PAO-3S	动词，现在进行时态，主动，祈愿语气，第三人称，单数
V-PAP-APF	动词，现在进行时态，主动，分词，直接受词，复数，阴性
V-PAP-APM	动词，现在进行时态，主动，分词，直接受词，复数，阳性
V-PAP-APN	动词，现在进行时态，主动，分词，直接受词，复数，中性
V-PAP-ASF	动词，现在进行时态，主动，分词，直接受词，单数，阴性
V-PAP-ASM	动词，现在进行时态，主动，分词，直接受词，单数，阳性
V-PAP-ASN	动词，现在进行时态，主动，分词，直接受词，单数，中性
V-PAP-DPF	动词，现在进行时态，主动，分词，间接受格，复数，阴性
V-PAP-DPM	动词，现在进行时态，主动，分词，间接受格，复数，阳性
V-PAP-DPN	动词，现在进行时态，主动，分词，间接受格，复数，中性
V-PAP-DSF	动词，现在进行时态，主动，分词，间接受格，单数，阴性
V-PAP-DSM	动词，现在进行时态，主动，分词，间接受格，单数，阳性
V-PAP-DSN	动词，现在进行时态，主动，分词，间接受格，单数，中性
V-PAP-GPF	动词，现在进行时态，主动，分词，所有格，复数，阴性
V-PAP-GPM	动词，现在进行时态，主动，分词，所有格，复数，阳性
V-PAP-GPN	动词，现在进行时态，主动，分词，所有格，复数，中性
V-PAP-GSF	动词，现在进行时态，主动，分词，所有格，单数，阴性
V-PAP-GSM	动词，现在进行时态，主动，分词，所有格，单数，阳性
V-PAP-GSN	动词，现在进行时态，主动，分词，所有格，单数，中性
V-PAP-NPF	动词，现在进行时态，主动，分词，主格，复数，阴性
V-PAP-NPM	动词，现在进行时态，主动，分词，主格，复数，阳性
V-PAP-NPN	动词，现在进行时态，主动，分词，主格，复数，中性
V-PAP-NSF	动词，现在进行时态，主动，分词，主格，单数，阴性
V-PAP-NSM	动词，现在进行时态，主动，分词，主格，单数，阳性
V-PAP-NSN	动词，现在进行时态，主动，分词，主格，单数，中性
V-PAP-VPM	动词，现在进行时态，主动，分词，呼格，复数，阳性
V-PAP-VSF	动词，现在进行时态，主动，分词，呼格，单数，阴性
V-PAP-VSM	动词，现在进行时态，主动，分词，呼格，单数，阳性
V-PAPDP	动词，现在进行时态，主动，分词，间接受格，复数
V-PAS-1P	动词，现在进行时态，主动，假设语气，第一人称，复数
V-PAS-1S	动词，现在进行时态，主动，假设语气，第一人称，单数
V-PAS-2P	动词，现在进行时态，主动，假设语气，第二人称，复数
V-PAS-2S	动词，现在进行时态，主动，假设语气，第二人称，单数
V-PAS-3P	动词，现在进行时态，主动，假设语气，第三人称，复数
V-PAS-3S	动词，现在进行时态，主动，假设语气，第三人称，单数
V-PDP-NPM	动词，现在进行时态，关身形主动意，分词，主格，复数，阳性
V-PEI-1P	动词，现在进行时态，关身或被动语态，直说语气，第一人称，复数
V-PEI-1S	动词，现在进行时态，关身或被动语态，直说语气，第一人称，单数
V-PEI-2P	动词，现在进行时态，关身或被动语态，直说语气，第二人称，复数
V-PEI-3P	动词，现在进行时态，关身或被动语态，直说语气，第三人称，复数
V-PEI-3S	动词，现在进行时态，关身或被动语态，直说语气，第三人称，单数
V-PEM-2P	动词，现在进行时态，关身或被动语态，命令语气，第二人称，复数
V-PEM-2S	动词，现在进行时态，关身或被动语态，命令语气，第二人称，单数
V-PEN	动词，现在进行时态，关身或被动语态，不定语气
V-PEP-ASM	动词，现在进行时态，关身或被动语态，分词，直接受词，单数，阳性
V-PEP-DPM	动词，现在进行时态，关身或被动语态，分词，间接受格，复数，阳性
V-PEP-DSM	动词，现在进行时态，关身或被动语态，分词，间接受格，单数，阳性
V-PEP-GPN	动词，现在进行时态，关身或被动语态，分词，所有格，复数，中性
V-PEP-GSF	动词，现在进行时态，关身或被动语态，分词，所有格，单数，阴性
V-PEP-GSM	动词，现在进行时态，关身或被动语态，分词，所有格，单数，阳性
V-PEP-NPF	动词，现在进行时态，关身或被动语态，分词，主格，复数，阴性
V-PEP-NPM	动词，现在进行时态，关身或被动语态，分词，主格，复数，阳性
V-PEP-NSF	动词，现在进行时态，关身或被动语态，分词，主格，单数，阴性
V-PMI-1P	动词，现在进行时态，关身语态，直说语气，第一人称，复数
V-PMI-1S	动词，现在进行时态，关身语态，直说语气，第一人称，单数
V-PMI-2P	动词，现在进行时态，关身语态，直说语气，第二人称，复数
V-PMI-2S	动词，现在进行时态，关身语态，直说语气，第二人称，单数
V-PMI-3P	动词，现在进行时态，关身语态，直说语气，第三人称，复数
V-PMI-3S	动词，现在进行时态，关身语态，直说语气，第三人称，单数
V-PMM-2P	动词，现在进行时态，关身语态，命令语气，第二人称，复数
V-PMM-2S	动词，现在进行时态，关身语态，命令语气，第二人称，单数
V-PMM-3P	动词，现在进行时态，关身语态，命令语气，第三人称，复数
V-PMM-3S	动词，现在进行时态，关身语态，命令语气，第三人称，单数
V-PMN	动词，现在进行时态，关身语态，不定语气
V-PMP-APF	动词，现在进行时态，关身语态，分词，直接受词，复数，阴性
V-PMP-APM	动词，现在进行时态，关身语态，分词，直接受词，复数，阳性
V-PMP-APN	动词，现在进行时态，关身语态，分词，直接受词，复数，中性
V-PMP-ASF	动词，现在进行时态，关身语态，分词，直接受词，单数，阴性
V-PMP-ASM	动词，现在进行时态，关身语态，分词，直接受词，单数，阳性
V-PMP-ASN	动词，现在进行时态，关身语态，分词，直接受词，单数，中性
V-PMP-DPM	动词，现在进行时态，关身语态，分词，间接受格，复数，阳性
V-PMP-DSF	动词，现在进行时态，关身语态，分词，间接受格，单数，阴性
V-PMP-DSM	动词，现在进行时态，关身语态，分词，间接受格，单数，阳性
V-PMP-GPF	动词，现在进行时态，关身语态，分词，所有格，复数，阴性
V-PMP-GPM	动词，现在进行时态，关身语态，分词，所有格，复数，阳性
V-PMP-GPN	动词，现在进行时态，关身语态，分词，所有格，复数，中性
V-PMP-GSF	动词，现在进行时态，关身语态，分词，所有格，单数，阴性
V-PMP-GSM	动词，现在进行时态，关身语态，分词，所有格，单数，阳性
V-PMP-GSM-T	动词，现在进行时态，关身语态，分词，所有格，单数，阳性，及物
V-PMP-GSN	动词，现在进行时态，关身语态，分词，所有格，单数，中性
V-PMP-NPF	动词，现在进行时态，关身语态，分词，主格，复数，阴性
V-PMP-NPM	动词，现在进行时态，关身语态，分词，主格，复数，阳性
V-PMP-NSF	动词，现在进行时态，关身语态，分词，主格，单数，阴性
V-PMP-NSM	动词，现在进行时态，关身语态，分词，主格，单数，阳性
V-PMP-NSN	动词，现在进行时态，关身语态，分词，主格，单数，中性
V-PMS-1P	动词，现在进行时态，关身语态，假设语气，第一人称，复数
V-PMS-1S	动词，现在进行时态，关身语态，假设语气，第一人称，单数
V-PMS-2S	动词，现在进行时态，关身语态，假设语气，第二人称，单数
V-PMS-3S	动词，现在进行时态，关身语态，假设语气，第三人称，单数
V-PNI-1P	动词，现在进行时态，关身形或被动形主动意，直说语气，第一人称，复数
V-PNI-1S	动词，现在进行时态，关身形或被动形主动意，直说语气，第一人称，单数
V-PNI-1S-C	动词，现在进行时态，关身形或被动形主动意，直说语气，第一人称，单数，缩略形式
V-PNI-2P	动词，现在进行时态，关身形或被动形主动意，直说语气，第二人称，复数
V-PNI-2S	动词，现在进行时态，关身形或被动形主动意，直说语气，第二人称，单数
V-PNI-2S-ATT	动词，现在进行时态，关身形或被动形主动意，直说语气，第二人称，单数，阿提卡形式
V-PNI-2S-C	动词，现在进行时态，关身形或被动形主动意，直说语气，第二人称，单数，缩略形式
V-PNI-3P	动词，现在进行时态，关身形或被动形主动意，直说语气，第三人称，复数
V-PNI-3S	动词，现在进行时态，关身形或被动形主动意，直说语气，第三人称，单数
V-PNI-3S-I	动词，现在进行时态，关身形或被动形主动意，直说语气，第三人称，单数
V-PNM-2P	动词，现在进行时态，关身形或被动形主动意，命令语气，第二人称，复数
V-PNM-2S	动词，现在进行时态，关身形或被动形主动意，命令语气，第二人称，单数
V-PNM-3P	动词，现在进行时态，关身形或被动形主动意，命令语气，第三人称，复数
V-PNM-3S	动词，现在进行时态，关身形或被动形主动意，命令语气，第三人称，单数
V-PNN	动词，现在进行时态，关身形或被动形主动意，不定语气
V-PNO-1S	动词，现在进行时态，关身形或被动形主动意，祈愿语气，第一人称，单数
V-PNO-3P	动词，现在进行时态，关身形或被动形主动意，祈愿语气，第三人称，复数
V-PNO-3S	动词，现在进行时态，关身形或被动形主动意，祈愿语气，第三人称，单数
V-PNP-APF	动词，现在进行时态，关身形或被动形主动意，分词，直接受词，复数，阴性
V-PNP-APM	动词，现在进行时态，关身形或被动形主动意，分词，直接受词，复数，阳性
V-PNP-APN	动词，现在进行时态，关身形或被动形主动意，分词，直接受词，复数，中性
V-PNP-ASF	动词，现在进行时态，关身形或被动形主动意，分词，直接受词，单数，阴性
V-PNP-ASM	动词，现在进行时态，关身形或被动形主动意，分词，直接受词，单数，阳性
V-PNP-ASN	动词，现在进行时态，关身形或被动形主动意，分词，直接受词，单数，中性
V-PNP-DPF	动词，现在进行时态，关身形或被动形主动意，分词，间接受格，复数，阴性
V-PNP-DPM	动词，现在进行时态，关身形或被动形主动意，分词，间接受格，复数，阳性
V-PNP-DPN	动词，现在进行时态，关身形或被动形主动意，分词，间接受格，复数，中性
V-PNP-DSF	动词，现在进行时态，关身形或被动形主动意，分词，间接受格，单数，阴性
V-PNP-DSM	动词，现在进行时态，关身形或被动形主动意，分词，间接受格，单数，阳性
V-PNP-DSN	动词，现在进行时态，关身形或被动形主动意，分词，间接受格，单数，中性
V-PNP-GPF	动词，现在进行时态，关身形或被动形主动意，分词，所有格，复数，阴性
V-PNP-GPM	动词，现在进行时态，关身形或被动形主动意，分词，所有格，复数，阳性
V-PNP-GPN	动词，现在进行时态，关身形或被动形主动意，分词，所有格，复数，中性
V-PNP-GSF	动词，现在进行时态，关身形或被动形主动意，分词，所有格，单数，阴性
V-PNP-GSM	动词，现在进行时态，关身形或被动形主动意，分词，所有格，单数，阳性
V-PNP-GSN	动词，现在进行时态，关身形或被动形主动意，分词，所有格，单数，中性
V-PNP-NPF	动词，现在进行时态，关身形或被动形主动意，分词，主格，复数，阴性
V-PNP-NPM	动词，现在进行时态，关身形或被动形主动意，分词，主格，复数，阳性
V-PNP-NPN	动词，现在进行时态，关身形或被动形主动意，分词，主格，复数，中性
V-PNP-NSF	动词，现在进行时态，关身形或被动形主动意，分词，主格，单数，阴性
V-PNP-NSM	动词，现在进行时态，关身形或被动形主动意，分词，主格，单数，阳性
V-PNP-NSN	动词，现在进行时态，关身形或被动形主动意，分词，主格，单数，中性
V-PNP-VPM	动词，现在进行时态，关身形或被动形主动意，分词，呼格，复数，阳性
V-PNP-VSM	动词，现在进行时态，关身形或被动形主动意，分词，呼格，单数，阳性
V-PNS-1P	动词，现在进行时态，关身形或被动形主动意，假设语气，第一人称，复数
V-PNS-1S	动词，现在进行时态，关身形或被动形主动意，假设语气，第一人称，单数
V-PNS-2P	动词，现在进行时态，关身形或被动形主动意，假设语气，第二人称，复数
V-PNS-2S	动词，现在进行时态，关身形或被动形主动意，假设语气，第二人称，单数
V-PNS-3P	动词，现在进行时态，关身形或被动形主动意，假设语气，第三人称，复数
V-PNS-3S	动词，现在进行时态，关身形或被动形主动意，假设语气，第三人称，单数
V-POP-NPM	动词，现在进行时态，被动形主动意，分词，主格，复数，阳性
V-PPI-1P	动词，现在进行时态，被动语态，直说语气，第一人称，复数
V-PPI-1S	动词，现在进行时态，被动语态，直说语气，第一人称，单数
V-PPI-2P	动词，现在进行时态，被动语态，直说语气，第二人称，复数
V-PPI-2S	动词，现在进行时态，被动语态，直说语气，第二人称，单数
V-PPI-2S-IRR	动词，现在进行时态，被动语态，直说语气，第二人称，单数，不规则形式
V-PPI-3P	动词，现在进行时态，被动语态，直说语气，第三人称，复数
V-PPI-3S	动词，现在进行时态，被动语态，直说语气，第三人称，单数
V-PPM-2P	动词，现在进行时态，被动语态，命令语气，第二人称，复数
V-PPM-2S	动词，现在进行时态，被动语态，命令语气，第二人称，单数
V-PPM-3P	动词，现在进行时态，被动语态，命令语气，第三人称，复数
V-PPM-3S	动词，现在进行时态，被动语态，命令语气，第三人称，单数
V-PPN	动词，现在进行时态，被动语态，不定语气
V-PPN-2P	动词，现在进行时态，被动语态，不定语气，第二人称，复数
V-PPP-APF	动词，现在进行时态，被动语态，分词，直接受词，复数，阴性
V-PPP-APM	动词，现在进行时态，被动语态，分词，直接受词，复数，阳性
V-PPP-APN	动词，现在进行时态，被动语态，分词，直接受词，复数，中性
V-PPP-ASF	动词，现在进行时态，被动语态，分词，直接受词，单数，阴性
V-PPP-ASM	动词，现在进行时态，被动语态，分词，直接受词，单数，阳性
V-PPP-ASN	动词，现在进行时态，被动语态，分词，直接受词，单数，中性
V-PPP-DPM	动词，现在进行时态，被动语态，分词，间接受格，复数，阳性
V-PPP-DPN	动词，现在进行时态，被动语态，分词，间接受格，复数，中性
V-PPP-DSF	动词，现在进行时态，被动语态，分词，间接受格，单数，阴性
V-PPP-DSM	动词，现在进行时态，被动语态，分词，间接受格，单数，阳性
V-PPP-DSN	动词，现在进行时态，被动语态，分词，间接受格，单数，中性
V-PPP-GPM	动词，现在进行时态，被动语态，分词，所有格，复数，阳性
V-PPP-GPN	动词，现在进行时态，被动语态，分词，所有格，复数，中性
V-PPP-GSF	动词，现在进行时态，被动语态，分词，所有格，单数，阴性
V-PPP-GSM	动词，现在进行时态，被动语态，分词，所有格，单数，阳性
V-PPP-GSN	动词，现在进行时态，被动语态，分词，所有格，单数，中性
V-PPP-NPF	动词，现在进行时态，被动语态，分词，主格，复数，阴性
V-PPP-NPM	动词，现在进行时态，被动语态，分词，主格，复数，阳性
V-PPP-NPN	动词，现在进行时态，被动语态，分词，主格，复数，中性
V-PPP-NSF	动词，现在进行时态，被动语态，分词，主格，单数，阴性
V-PPP-NSM	动词，现在进行时态，被动语态，分词，主格，单数，阳性
V-PPP-NSN	动词，现在进行时态，被动语态，分词，主格，单数，中性
V-PPS-1P	动词，现在进行时态，被动语态，假设语气，第一人称，复数
V-PPS-1S	动词，现在进行时态，被动语态，假设语气，第一人称，单数
V-PPS-2P	动词，现在进行时态，被动语态，假设语气，第二人称，复数
V-PPS-3P	动词，现在进行时态，被动语态，假设语气，第三人称，复数
V-PPS-3S	动词，现在进行时态，被动语态，假设语气，第三人称，单数
V-PQI-3S	动词，现在进行时态，非人格主动，直说语气，第三人称，单数
V-PQN	动词，现在进行时态，非人格主动，不定语气
V-PQP-APN	动词，现在进行时态，非人格主动，分词，直接受词，复数，中性
V-PQP-NSN	动词，现在进行时态，非人格主动，分词，主格，单数，中性
V-PQS-3S	动词，现在进行时态，非人格主动，假设语气，第三人称，单数
V-PXI-1P	动词，现在进行时态，无指定语态，直说语气，第一人称，复数
V-PXI-1S	动词，现在进行时态，无指定语态，直说语气，第一人称，单数
V-PXI-2P	动词，现在进行时态，无指定语态，直说语气，第二人称，复数
V-PXI-2S	动词，现在进行时态，无指定语态，直说语气，第二人称，单数
V-PXI-3P	动词，现在进行时态，无指定语态，直说语气，第三人称，复数
V-PXI-3S	动词，现在进行时态，无指定语态，直说语气，第三人称，单数
V-PXM-2S	动词，现在进行时态，无指定语态，命令语气，第二人称，单数
V-PXM-3P	动词，现在进行时态，无指定语态，命令语气，第三人称，复数
V-PXM-3S	动词，现在进行时态，无指定语态，命令语气，第三人称，单数
V-PXN	动词，现在进行时态，无指定语态，不定语气
V-PXO-2S	动词，现在进行时态，无指定语态，祈愿语气，第二人称，单数
V-PXO-3S	动词，现在进行时态，无指定语态，祈愿语气，第三人称，单数
V-PXP-APM	动词，现在进行时态，无指定语态，分词，直接受词，复数，阳性
V-PXP-APN	动词，现在进行时态，无指定语态，分词，直接受词，复数，中性
V-PXP-ASF	动词，现在进行时态，无指定语态，分词，直接受词，单数，阴性
V-PXP-ASM	动词，现在进行时态，无指定语态，分词，直接受词，单数，阳性
V-PXP-ASN	动词，现在进行时态，无指定语态，分词，直接受词，单数，中性
V-PXP-DPM	动词，现在进行时态，无指定语态，分词，间接受格，复数，阳性
V-PXP-DPN	动词，现在进行时态，无指定语态，分词，间接受格，复数，中性
V-PXP-DSF	动词，现在进行时态，无指定语态，分词，间接受格，单数，阴性
V-PXP-DSM	动词，现在进行时态，无指定语态，分词，间接受格，单数，阳性
V-PXP-GPF	动词，现在进行时态，无指定语态，分词，所有格，复数，阴性
V-PXP-GPM	动词，现在进行时态，无指定语态，分词，所有格，复数，阳性
V-PXP-GPN	动词，现在进行时态，无指定语态，分词，所有格，复数，中性
V-PXP-GSF	动词，现在进行时态，无指定语态，分词，所有格，单数，阴性
V-PXP-GSM	动词，现在进行时态，无指定语态，分词，所有格，单数，阳性
V-PXP-GSN	动词，现在进行时态，无指定语态，分词，所有格，单数，中性
V-PXP-NPF	动词，现在进行时态，无指定语态，分词，主格，复数，阴性
V-PXP-NPM	动词，现在进行时态，无指定语态，分词，主格，复数，阳性
V-PXP-NPN	动词，现在进行时态，无指定语态，分词，主格，复数，中性
V-PXP-NSF	动词，现在进行时态，无指定语态，分词，主格，单数，阴性
V-PXP-NSM	动词，现在进行时态，无指定语态，分词，主格，单数，阳性
V-PXP-NSN	动词，现在进行时态，无指定语态，分词，主格，单数，中性
V-PXS-1P	动词，现在进行时态，无指定语态，假设语气，第一人称，复数
V-PXS-1S	动词，现在进行时态，无指定语态，假设语气，第一人称，单数
V-PXS-2P	动词，现在进行时态，无指定语态，假设语气，第二人称，复数
V-PXS-2S	动词，现在进行时态，无指定语态，假设语气，第二人称，单数
V-PXS-3P	动词，现在进行时态，无指定语态，假设语气，第三人称，复数
V-PXS-3S	动词，现在进行时态，无指定语态，假设语气，第三人称，单数
V-RAI-1P	动词，现在完成时态，主动，直说语气，第一人称，复数
V-RAI-1P-ATT	动词，现在完成时态，主动，直说语气，第一人称，复数，阿提卡形式
V-RAI-1S	动词，现在完成时态，主动，直说语气，第一人称，单数
V-RAI-1S-ATT	动词，现在完成时态，主动，直说语气，第一人称，单数，阿提卡形式
V-RAI-2P	动词，现在完成时态，主动，直说语气，第二人称，复数
V-RAI-2P-ATT	动词，现在完成时态，主动，直说语气，第二人称，复数，阿提卡形式
V-RAI-2S	动词，现在完成时态，主动，直说语气，第二人称，单数
V-RAI-2S-ATT	动词，现在完成时态，主动，直说语气，第二人称，单数，阿提卡形式
V-RAI-3P	动词，现在完成时态，主动，直说语气，第三人称，复数
V-RAI-3P-ATT	动词，现在完成时态，主动，直说语气，第三人称，复数，阿提卡形式
V-RAI-3S	动词，现在完成时态，主动，直说语气，第三人称，单数
V-RAI-3S-ATT	动词，现在完成时态，主动，直说语气，第三人称，单数，阿提卡形式
V-RAM-2P	动词，现在完成时态，主动，命令语气，第二人称，复数
V-RAN	动词，现在完成时态，主动，不定语气
V-RAN-ATT	动词，现在完成时态，主动，不定语气，直接受词
V-RAP-APM	动词，现在完成时态，主动，分词，直接受词，复数，阳性
V-RAP-APN	动词，现在完成时态，主动，分词，直接受词，复数，中性
V-RAP-ASF	动词，现在完成时态，主动，分词，直接受词，单数，阴性
V-RAP-ASM	动词，现在完成时态，主动，分词，直接受词，单数，阳性
V-RAP-ASM-C	动词，现在完成时态，主动，分词，直接受词，单数，阳性，缩略形式
V-RAP-ASN	动词，现在完成时态，主动，分词，直接受词，单数，中性
V-RAP-DPM	动词，现在完成时态，主动，分词，间接受格，复数，阳性
V-RAP-DSM	动词，现在完成时态，主动，分词，间接受格，单数，阳性
V-RAP-DSN	动词，现在完成时态，主动，分词，间接受格，单数，中性
V-RAP-GPM	动词，现在完成时态，主动，分词，所有格，复数，阳性
V-RAP-GPN	动词，现在完成时态，主动，分词，所有格，复数，中性
V-RAP-GSF	动词，现在完成时态，主动，分词，所有格，单数，阴性
V-RAP-GSM	动词，现在完成时态，主动，分词，所有格，单数，阳性
V-RAP-GSM-ATT	动词，现在完成时态，主动，分词，所有格，单数，阳性，阿提卡形式
V-RAP-GSN-ATT	动词，现在完成时态，主动，分词，所有格，单数，中性，阿提卡形式
V-RAP-NPF	动词，现在完成时态，主动，分词，主格，复数，阴性
V-RAP-NPM	动词，现在完成时态，主动，分词，主格，复数，阳性
V-RAP-NPM-ATT	动词，现在完成时态，主动，分词，主格，复数，阳性，阿提卡形式
V-RAP-NPM-C	动词，现在完成时态，主动，分词，主格，复数，阳性，缩略形式
V-RAP-NPN	动词，现在完成时态，主动，分词，主格，复数，中性
V-RAP-NSF	动词，现在完成时态，主动，分词，主格，单数，阴性
V-RAP-NSM	动词，现在完成时态，主动，分词，主格，单数，阳性
V-RAP-NSM-ATT	动词，现在完成时态，主动，分词，主格，单数，阳性，阿提卡形式
V-RAP-NSN	动词，现在完成时态，主动，分词，主格，单数，中性
V-RAS-1P	动词，现在完成时态，主动，假设语气，第一人称，复数
V-RAS-1S	动词，现在完成时态，主动，假设语气，第一人称，单数
V-RAS-2P	动词，现在完成时态，主动，假设语气，第二人称，复数
V-RAS-2S	动词，现在完成时态，主动，假设语气，第二人称，单数
V-RDI-3S	动词，现在完成时态，关身形主动意，直说语气，第三人称，单数
V-REP-NSF	动词，现在完成时态，关身或被动语态，分词，主格，单数，阴性
V-REP-VSF	动词，现在完成时态，关身或被动语态，分词，呼格，单数，阴性
V-RMI-1S	动词，现在完成时态，关身语态，直说语气，第一人称，单数
V-RMI-2P	动词，现在完成时态，关身语态，直说语气，第二人称，复数
V-RMI-2S	动词，现在完成时态，关身语态，直说语气，第二人称，单数
V-RMI-3S	动词，现在完成时态，关身语态，直说语气，第三人称，单数
V-RMM-2P	动词，现在完成时态，关身语态，命令语气，第二人称，复数
V-RMP-APM	动词，现在完成时态，关身语态，分词，直接受词，复数，阳性
V-RMP-ASM	动词，现在完成时态，关身语态，分词，直接受词，单数，阳性
V-RMP-DPM	动词，现在完成时态，关身语态，分词，间接受格，复数，阳性
V-RMP-GPM	动词，现在完成时态，关身语态，分词，所有格，复数，阳性
V-RMP-GSF	动词，现在完成时态，关身语态，分词，所有格，单数，阴性
V-RMP-NPM	动词，现在完成时态，关身语态，分词，主格，复数，阳性
V-RMP-NSM	动词，现在完成时态，关身语态，分词，主格，单数，阳性
V-RNI-1P	动词，现在完成时态，关身形或被动形主动意，直说语气，第一人称，复数
V-RNI-1S	动词，现在完成时态，关身形或被动形主动意，直说语气，第一人称，单数
V-RNI-3S	动词，现在完成时态，关身形或被动形主动意，直说语气，第三人称，单数
V-RNN	动词，现在完成时态，关身形或被动形主动意，不定语气
V-RNP-APM	动词，现在完成时态，关身形或被动形主动意，分词，直接受词，复数，阳性
V-RNP-ASF	动词，现在完成时态，关身形或被动形主动意，分词，直接受词，单数，阴性
V-RNP-DPF	动词，现在完成时态，关身形或被动形主动意，分词，间接受格，复数，阴性
V-RNP-NPM	动词，现在完成时态，关身形或被动形主动意，分词，主格，复数，阳性
V-RNP-NSM	动词，现在完成时态，关身形或被动形主动意，分词，主格，单数，阳性
V-RPI-1P	动词，现在完成时态，被动语态，直说语气，第一人称，复数
V-RPI-1S	动词，现在完成时态，被动语态，直说语气，第一人称，单数
V-RPI-2P	动词，现在完成时态，被动语态，直说语气，第二人称，复数
V-RPI-2S	动词，现在完成时态，被动语态，直说语气，第二人称，单数
V-RPI-3P	动词，现在完成时态，被动语态，直说语气，第三人称，复数
V-RPI-3S	动词，现在完成时态，被动语态，直说语气，第三人称，单数
V-RPM-2P	动词，现在完成时态，被动语态，命令语气，第二人称，复数
V-RPM-2S	动词，现在完成时态，被动语态，命令语气，第二人称，单数
V-RPN	动词，现在完成时态，被动语态，不定语气
V-RPP-APF	动词，现在完成时态，被动语态，分词，直接受词，复数，阴性
V-RPP-APM	动词，现在完成时态，被动语态，分词，直接受词，复数，阳性
V-RPP-APN	动词，现在完成时态，被动语态，分词，直接受词，复数，中性
V-RPP-ASF	动词，现在完成时态，被动语态，分词，直接受词，单数，阴性
V-RPP-ASM	动词，现在完成时态，被动语态，分词，直接受词，单数，阳性
V-RPP-ASN	动词，现在完成时态，被动语态，分词，直接受词，单数，中性
V-RPP-ASN-ATT	动词，现在完成时态，被动语态，分词，直接受词，单数，中性，阿提卡形式
V-RPP-DPM	动词，现在完成时态，被动语态，分词，间接受格，复数，阳性
V-RPP-DPN	动词，现在完成时态，被动语态，分词，间接受格，复数，中性
V-RPP-DSF	动词，现在完成时态，被动语态，分词，间接受格，单数，阴性
V-RPP-DSM	动词，现在完成时态，被动语态，分词，间接受格，单数，阳性
V-RPP-DSN	动词，现在完成时态，被动语态，分词，间接受格，单数，中性
V-RPP-GPF	动词，现在完成时态，被动语态，分词，所有格，复数，阴性
V-RPP-GPM	动词，现在完成时态，被动语态，分词，所有格，复数，阳性
V-RPP-GPN	动词，现在完成时态，被动语态，分词，所有格，复数，中性
V-RPP-GSF	动词，现在完成时态，被动语态，分词，所有格，单数，阴性
V-RPP-GSM	动词，现在完成时态，被动语态，分词，所有格，单数，阳性
V-RPP-GSN	动词，现在完成时态，被动语态，分词，所有格，单数，中性
V-RPP-NPF	动词，现在完成时态，被动语态，分词，主格，复数，阴性
V-RPP-NPM	动词，现在完成时态，被动语态，分词，主格，复数，阳性
V-RPP-NPN	动词，现在完成时态，被动语态，分词，主格，复数，中性
V-RPP-NSF	动词，现在完成时态，被动语态，分词，主格，单数，阴性
V-RPP-NSM	动词，现在完成时态，被动语态，分词，主格，单数，阳性
V-RPP-NSN	动词，现在完成时态，被动语态，分词，主格，单数，中性
V-RPP-NSN-ATT	动词，现在完成时态，被动语态，分词，主格，单数，中性，阿提卡形式
V-RPP-VPM	动词，现在完成时态，被动语态，分词，呼格，复数，阳性
V-RPP-VSF	动词，现在完成时态，被动语态，分词，呼格，单数，阴性
V-RPP-VSM	动词，现在完成时态，被动语态，分词，呼格，单数，阳性
V-XXM-2P	动词，无指定时态，无指定语态，命令语气，第二人称，复数
V-XXM-2S	动词，无指定时态，无指定语态，命令语气，第二人称，单数
X-APF	不定代名词，直接受词，复数，阴性
X-APM	不定代名词，直接受词，复数，阳性
X-APN	不定代名词，直接受词，复数，中性
X-ASF	不定代名词，直接受词，单数，阴性
X-ASM	不定代名词，直接受词，单数，阳性
X-ASN	不定代名词，直接受词，单数，中性
X-DPM	不定代名词，间接受格，复数，阳性
X-DSF	不定代名词，间接受格，单数，阴性
X-DSM	不定代名词，间接受格，单数，阳性
X-DSN	不定代名词，间接受格，单数，中性
X-GPF	不定代名词，所有格，复数，阴性
X-GPM	不定代名词，所有格，复数，阳性
X-GPN	不定代名词，所有格，复数，中性
X-GSF	不定代名词，所有格，单数，阴性
X-GSM	不定代名词，所有格，单数，阳性
X-GSN	不定代名词，所有格，单数，中性
X-NPF	不定代名词，主格，复数，阴性
X-NPM	不定代名词，主格，复数，阳性
X-NPN	不定代名词，主格，复数，中性
X-NSF	不定代名词，主格，单数，阴性
X-NSM	不定代名词，主格，单数，阳性
X-NSN	不定代名词，主格，单数，中性
