RMAC	中文解釋
A-APF	形容詞，直接受詞，複數，陰性
A-APF-C	形容詞，直接受詞，複數，陰性，比較級
A-APF-NUI	形容詞，直接受詞，複數，陰性，無變格數字（形容詞）
A-APF-S	形容詞，直接受詞，複數，陰性，最上級
A-APM	形容詞，直接受詞，複數，陽性
A-APM-C	形容詞，直接受詞，複數，陽性，比較級
A-APM-LG	形容詞，直接受詞，複數，陽性，非猶太地名
A-APM-NUI	形容詞，直接受詞，複數，陽性，無變格數字（形容詞）
A-APM-PG	形容詞，直接受詞，複數，陽性，非猶太人名
A-APM-S	形容詞，直接受詞，複數，陽性，最上級
A-APN	形容詞，直接受詞，複數，中性
A-APN-C	形容詞，直接受詞，複數，中性，比較級
A-APN-NUI	形容詞，直接受詞，複數，中性，無變格數字（形容詞）
A-APN-S	形容詞，直接受詞，複數，中性，最上級
A-ASF	形容詞，直接受詞，單數，陰性
A-ASF-C	形容詞，直接受詞，單數，陰性，比較級
A-ASF-L	形容詞，直接受詞，單數，陰性，地名
A-ASF-LG	形容詞，直接受詞，單數，陰性，非猶太地名
A-ASF-N	形容詞，直接受詞，單數，陰性，否定詞
A-ASF-PG	形容詞，直接受詞，單數，陰性，非猶太人名
A-ASF-S	形容詞，直接受詞，單數，陰性，最上級
A-ASM	形容詞，直接受詞，單數，陽性
A-ASM-C	形容詞，直接受詞，單數，陽性，比較級
A-ASM-LG	形容詞，直接受詞，單數，陽性，非猶太地名
A-ASM-N	形容詞，直接受詞，單數，陽性，否定詞
A-ASM-PG	形容詞，直接受詞，單數，陽性，非猶太人名
A-ASM-S	形容詞，直接受詞，單數，陽性，最上級
A-ASN	形容詞，直接受詞，單數，中性
A-ASN-C	形容詞，直接受詞，單數，中性，比較級
A-ASN-LG	形容詞，直接受詞，單數，中性，非猶太地名
A-ASN-N	形容詞，直接受詞，單數，中性，否定詞
A-ASN-S	形容詞，直接受詞，單數，中性，最上級
A-DPF	形容詞，間接受格，複數，陰性
A-DPF-C	形容詞，間接受格，複數，陰性，比較級
A-DPF-NUI	形容詞，間接受格，複數，陰性，無變格數字（形容詞）
A-DPF-S	形容詞，間接受格，複數，陰性，最上級
A-DPM	形容詞，間接受格，複數，陽性
A-DPM-C	形容詞，間接受格，複數，陽性，比較級
A-DPM-LG	形容詞，間接受格，複數，陽性，非猶太地名
A-DPM-NUI	形容詞，間接受格，複數，陽性，無變格數字（形容詞）
A-DPM-PG	形容詞，間接受格，複數，陽性，非猶太人名
A-DPM-S	形容詞，間接受格，複數，陽性，最上級
A-DPN	形容詞，間接受格，複數，中性
A-DPN-LG	形容詞，間接受格，複數，中性，非猶太地名
A-DPN-NUI	形容詞，間接受格，複數，中性，無變格數字（形容詞）
A-DPN-S	形容詞，間接受格，複數，中性，最上級
A-DSF	形容詞，間接受格，單數，陰性
A-DSF-C	形容詞，間接受格，單數，陰性，比較級
A-DSF-L	形容詞，間接受格，單數，陰性，地名
A-DSF-LG	形容詞，間接受格，單數，陰性，非猶太地名
A-DSF-PG	形容詞，間接受格，單數，陰性，非猶太人名
A-DSF-S	形容詞，間接受格，單數，陰性，最上級
A-DSM	形容詞，間接受格，單數，陽性
A-DSM-C	形容詞，間接受格，單數，陽性，比較級
A-DSM-N	形容詞，間接受格，單數，陽性，否定詞
A-DSM-PG	形容詞，間接受格，單數，陽性，非猶太人名
A-DSM-S	形容詞，間接受格，單數，陽性，最上級
A-DSN	形容詞，間接受格，單數，中性
A-DSN-C	形容詞，間接受格，單數，中性，比較級
A-DSN-LG	形容詞，間接受格，單數，中性，非猶太地名
A-DSN-N	形容詞，間接受格，單數，中性，否定詞
A-DSN-S	形容詞，間接受格，單數，中性，最上級
A-GMS	形容詞，所有格，陽性，最上級
A-GPF	形容詞，所有格，複數，陰性
A-GPF-L	形容詞，所有格，複數，陰性，地名
A-GPF-NUI	形容詞，所有格，複數，陰性，無變格數字（形容詞）
A-GPF-S	形容詞，所有格，複數，陰性，最上級
A-GPM	形容詞，所有格，複數，陽性
A-GPM-C	形容詞，所有格，複數，陽性，比較級
A-GPM-LG	形容詞，所有格，複數，陽性，非猶太地名
A-GPM-NUI	形容詞，所有格，複數，陽性，無變格數字（形容詞）
A-GPM-PG	形容詞，所有格，複數，陽性，非猶太人名
A-GPM-S	形容詞，所有格，複數，陽性，最上級
A-GPN	形容詞，所有格，複數，中性
A-GPN-C	形容詞，所有格，複數，中性，比較級
A-GPN-NUI	形容詞，所有格，複數，中性，無變格數字（形容詞）
A-GPN-S	形容詞，所有格，複數，中性，最上級
A-GSF	形容詞，所有格，單數，陰性
A-GSF-C	形容詞，所有格，單數，陰性，比較級
A-GSF-L	形容詞，所有格，單數，陰性，地名
A-GSF-LG	形容詞，所有格，單數，陰性，非猶太地名
A-GSF-PG	形容詞，所有格，單數，陰性，非猶太人名
A-GSF-S	形容詞，所有格，單數，陰性，最上級
A-GSM	形容詞，所有格，單數，陽性
A-GSM-C	形容詞，所有格，單數，陽性，比較級
A-GSM-N	形容詞，所有格，單數，陽性，否定詞
A-GSM-PG	形容詞，所有格，單數，陽性，非猶太人名
A-GSM-S	形容詞，所有格，單數，陽性，最上級
A-GSN	形容詞，所有格，單數，中性
A-GSN-N	形容詞，所有格，單數，中性，否定詞
A-GSN-S	形容詞，所有格，單數，中性，最上級
A-NPF	形容詞，主格，複數，陰性
A-NPF-C	形容詞，主格，複數，陰性，比較級
A-NPF-NUI	形容詞，主格，複數，陰性，無變格數字（形容詞）
A-NPF-S	形容詞，主格，複數，陰性，最上級
A-NPM	形容詞，主格，複數，陽性
A-NPM-C	形容詞，主格，複數，陽性，比較級
A-NPM-LG	形容詞，主格，複數，陽性，非猶太地名
A-NPM-NUI	形容詞，主格，複數，陽性，無變格數字（形容詞）
A-NPM-PG	形容詞，主格，複數，陽性，非猶太人名
A-NPM-S	形容詞，主格，複數，陽性，最上級
A-NPN	形容詞，主格，複數，中性
A-NPN-C	形容詞，主格，複數，中性，比較級
A-NPN-NUI	形容詞，主格，複數，中性，無變格數字（形容詞）
A-NPN-S	形容詞，主格，複數，中性，最上級
A-NSF	形容詞，主格，單數，陰性
A-NSF-C	形容詞，主格，單數，陰性，比較級
A-NSF-LG	形容詞，主格，單數，陰性，非猶太地名
A-NSF-N	形容詞，主格，單數，陰性，否定詞
A-NSF-S	形容詞，主格，單數，陰性，最上級
A-NSM	形容詞，主格，單數，陽性
A-NSM-ATT	形容詞，主格，單數，陽性，阿提卡希臘語
A-NSM-C	形容詞，主格，單數，陽性，比較級
A-NSM-LG	形容詞，主格，單數，陽性，非猶太地名
A-NSM-N	形容詞，主格，單數，陽性，否定詞
A-NSM-PG	形容詞，主格，單數，陽性，非猶太人名
A-NSM-S	形容詞，主格，單數，陽性，最上級
A-NSM-T	形容詞，主格，單數，陽性，稱謂
A-NSN	形容詞，主格，單數，中性
A-NSN-C	形容詞，主格，單數，中性，比較級
A-NSN-N	形容詞，主格，單數，中性，中性
A-NSN-S	形容詞，主格，單數，中性，最上級
A-NUI	無變格數字（形容詞）
A-NUI-ABB	形容詞，主格，縮寫形式
A-VPF	形容詞，呼格，複數，陰性
A-VPM	形容詞，呼格，複數，陽性
A-VPM-C	形容詞，呼格，複數，陽性，比較級
A-VPM-PG	形容詞，呼格，複數，陽性，非猶太人名
A-VPN	形容詞，呼格，複數，中性
A-VSF	形容詞，呼格，單數，陰性
A-VSM	形容詞，呼格，單數，陽性
A-VSM-S	形容詞，呼格，單數，陽性，最上級
A-VSN	形容詞，呼格，單數，中性
ADV	副詞／副詞＋質詞
ADV-C	副詞，縮略形式
ADV-I	副詞，疑問詞
ADV-K	副詞，Kai
ADV-N	副詞，否定詞
ADV-S	副詞，最上級
ARAM	亞蘭文音譯詞（無變格）
C-APM	互相代名詞，直接受詞，複數，陽性
C-DPM	互相代名詞，間接受格，複數，陽性
C-DPN	互相代名詞，間接受格，複數，中性
C-GPM	互相代名詞，所有格，複數，陽性
C-GPN	互相代名詞，所有格，複數，中性
COND	條件質詞或連接詞
COND-C	縮略形式
COND-K	條件質詞，Kai
COND-P	縮略形式
CONJ	連接詞／連接質詞
CONJ-N	連接詞，否定詞
D-APF	指示代名詞，直接受詞，複數，陰性
D-APM	指示代名詞，直接受詞，複數，陽性
D-APM-C	指示代名詞，直接受詞，複數，陽性，縮略形式
D-APM-K	指示代名詞，直接受詞，複數，陽性，Kai
D-APN	指示代名詞，直接受詞，複數，中性
D-APN-K	指示代名詞，直接受詞，複數，中性，Kai
D-ASF	指示代名詞，直接受詞，單數，陰性
D-ASM	指示代名詞，直接受詞，單數，陽性
D-ASM-C	指示代名詞，直接受詞，單數，陽性，縮略形式
D-ASM-K	指示代名詞，直接受詞，單數，陽性，Kai
D-ASN	指示代名詞，直接受詞，單數，中性
D-DPF	指示代名詞，間接受格，複數，陰性
D-DPM	指示代名詞，間接受格，複數，陽性
D-DPM-C	指示代名詞，間接受格，複數，陽性，縮略形式
D-DPN	指示代名詞，間接受格，複數，中性
D-DSF	指示代名詞，間接受格，單數，陰性
D-DSM	指示代名詞，間接受格，單數，陽性
D-DSN	指示代名詞，間接受格，單數，中性
D-GPF	指示代名詞，所有格，複數，陰性
D-GPM	指示代名詞，所有格，複數，陽性
D-GPN	指示代名詞，所有格，複數，中性
D-GSF	指示代名詞，所有格，單數，陰性
D-GSM	指示代名詞，所有格，單數，陽性
D-GSN	指示代名詞，所有格，單數，中性
D-NPF	指示代名詞，主格，複數，陰性
D-NPM	指示代名詞，主格，複數，陽性
D-NPM-C	指示代名詞，主格，複數，陽性，縮略形式
D-NPM-K	指示代名詞，主格，複數，陽性，Kai
D-NPN	指示代名詞，主格，複數，中性
D-NPN-C	指示代名詞，主格，複數，中性，縮略形式
D-NPN-K	指示代名詞，主格，複數，中性，Kai
D-NSF	指示代名詞，主格，單數，陰性
D-NSM	指示代名詞，主格，單數，陽性
D-NSM-C	指示代名詞，主格，單數，陽性，縮略形式
D-NSM-K	指示代名詞，主格，單數，陽性，Kai
D-NSN	指示代名詞，主格，單數，中性
F-1APM	反身代名詞，第一人稱，直接受詞，複數，陽性
F-1ASM	反身代名詞，第一人稱，直接受詞，單數，陽性
F-1DPM	反身代名詞，第一人稱，間接受格，複數，陽性
F-1DSM	反身代名詞，第一人稱，間接受格，單數，陽性
F-1GPM	反身代名詞，第一人稱，所有格，複數，陽性
F-1GSM	反身代名詞，第一人稱，所有格，單數，陽性
F-2APF	反身代名詞，第二人稱，直接受詞，複數，陰性
F-2APM	反身代名詞，第二人稱，直接受詞，複數，陽性
F-2APN	反身代名詞，第二人稱，直接受詞，複數，中性
F-2ASM	反身代名詞，第二人稱，直接受詞，單數，陽性
F-2ASM-C	反身代名詞，第二人稱，直接受詞，單數，陽性，縮略形式
F-2DPF	反身代名詞，第二人稱，間接受格，複數，陰性
F-2DPM	反身代名詞，第二人稱，間接受格，複數，陽性
F-2DSM	反身代名詞，第二人稱，間接受格，單數，陽性
F-2GPM	反身代名詞，第二人稱，所有格，複數，陽性
F-2GSM	反身代名詞，第二人稱，所有格，單數，陽性
F-3APF	反身代名詞，第三人稱，直接受詞，複數，陰性
F-3APM	反身代名詞，第三人稱，直接受詞，複數，陽性
F-3APN	反身代名詞，第三人稱，直接受詞，複數，中性
F-3ASF	反身代名詞，第三人稱，直接受詞，單數，陰性
F-3ASM	反身代名詞，第三人稱，直接受詞，單數，陽性
F-3ASN	反身代名詞，第三人稱，直接受詞，單數，中性
F-3DPF	反身代名詞，第三人稱，間接受格，複數，陰性
F-3DPM	反身代名詞，第三人稱，間接受格，複數，陽性
F-3DSF	反身代名詞，第三人稱，間接受格，單數，陰性
F-3DSM	反身代名詞，第三人稱，間接受格，單數，陽性
F-3GPF	反身代名詞，第三人稱，所有格，複數，陰性
F-3GPM	反身代名詞，第三人稱，所有格，複數，陽性
F-3GPN	反身代名詞，第三人稱，所有格，複數，中性
F-3GSF	反身代名詞，第三人稱，所有格，單數，陰性
F-3GSM	反身代名詞，第三人稱，所有格，單數，陽性
F-3GSN	反身代名詞，第三人稱，所有格，單數，中性
F-3NSM	反身代名詞，第三人稱，主格，單數，陽性
F-GPF	反身代名詞，所有格，複數，陰性
HEB	希伯來文音譯詞（無變格）
HEB-T	希伯來文，稱謂
I-APF	疑問代名詞，直接受詞，複數，陰性
I-APM	疑問代名詞，直接受詞，複數，陽性
I-APN	疑問代名詞，直接受詞，複數，中性
I-ASF	疑問代名詞，直接受詞，單數，陰性
I-ASM	疑問代名詞，直接受詞，單數，陽性
I-ASN	疑問代名詞，直接受詞，單數，中性
I-DPM	疑問代名詞，間接受格，複數，陽性
I-DPN	疑問代名詞，間接受格，複數，中性
I-DSF	疑問代名詞，間接受格，單數，陰性
I-DSM	疑問代名詞，間接受格，單數，陽性
I-DSN	疑問代名詞，間接受格，單數，中性
I-GPM	疑問代名詞，所有格，複數，陽性
I-GPN	疑問代名詞，所有格，複數，中性
I-GSF	疑問代名詞，所有格，單數，陰性
I-GSM	疑問代名詞，所有格，單數，陽性
I-GSN	疑問代名詞，所有格，單數，中性
I-NPF	疑問代名詞，主格，複數，陰性
I-NPM	疑問代名詞，主格，複數，陽性
I-NPN	疑問代名詞，主格，複數，中性
I-NSF	疑問代名詞，主格，單數，陰性
I-NSM	疑問代名詞，主格，單數，陽性
I-NSN	疑問代名詞，主格，單數，中性
INJ	感嘆詞
K-APF	相關代名詞，直接受詞，複數，陰性
K-APM	相關代名詞，直接受詞，複數，陽性
K-APN	相關代名詞，直接受詞，複數，中性
K-ASM	相關代名詞，直接受詞，單數，陽性
K-ASN	相關代名詞，直接受詞，單數，中性
K-DSN	相關代名詞，間接受格，單數，中性
K-GPM	相關代名詞，所有格，複數，陽性
K-GSN	相關代名詞，所有格，單數，中性
K-NPF	相關代名詞，主格，複數，陰性
K-NPM	相關代名詞，主格，複數，陽性
K-NPN	相關代名詞，主格，複數，中性
K-NSF	相關代名詞，主格，單數，陰性
K-NSM	相關代名詞，主格，單數，陽性
K-NSN	相關代名詞，主格，單數，中性
N-APF	名詞，直接受詞，複數，陰性
N-APF-C	名詞，直接受詞，複數，陰性，縮略形式
N-APF-L	名詞，直接受詞，複數，陰性，地名
N-APF-S	名詞，直接受詞，複數，陰性，最上級
N-APM	名詞，直接受詞，複數，陽性
N-APM-L	名詞，直接受詞，複數，陽性，地名
N-APM-LG	名詞，直接受詞，複數，陽性，非猶太地名
N-APM-P	名詞，直接受詞，複數，陽性，人名
N-APM-PG	名詞，直接受詞，複數，陽性，非猶太人名
N-APM-T	名詞，直接受詞，複數，陽性，稱謂
N-APN	名詞，直接受詞，複數，中性
N-APN-C	名詞，直接受詞，複數，中性，縮略形式
N-APN-L	名詞，直接受詞，複數，中性，地名
N-APN-S	名詞，直接受詞，複數，中性，最上級
N-ASF	名詞，直接受詞，單數，陰性
N-ASF-C	名詞，直接受詞，單數，陰性，縮略形式
N-ASF-L	名詞，直接受詞，單數，陰性，地名
N-ASF-P	名詞，直接受詞，單數，陰性，人名
N-ASF-S	名詞，直接受詞，單數，陰性，最上級
N-ASF-T	名詞，直接受詞，單數，陰性，稱謂
N-ASM	名詞，直接受詞，單數，陽性
N-ASM-L	名詞，直接受詞，單數，陽性，地名
N-ASM-LG	名詞，直接受詞，單數，陽性，非猶太地名
N-ASM-P	名詞，直接受詞，單數，陽性，人名
N-ASM-S	名詞，直接受詞，單數，陽性，最上級
N-ASM-T	名詞，直接受詞，單數，陽性，稱謂
N-ASN	名詞，直接受詞，單數，中性
N-ASN-L	名詞，直接受詞，單數，中性，地名
N-DPF	名詞，間接受格，複數，陰性
N-DPF-L	名詞，間接受格，複數，陰性，地名
N-DPM	名詞，間接受格，複數，陽性
N-DPM-L	名詞，間接受格，複數，陽性，地名
N-DPM-LG	名詞，間接受格，複數，陽性，非猶太地名
N-DPM-S	名詞，間接受格，複數，陽性，最上級
N-DPM-T	名詞，間接受格，複數，陽性，稱謂
N-DPN	名詞，間接受格，複數，中性
N-DPN-L	名詞，間接受格，複數，中性，地名
N-DSF	名詞，間接受格，單數，陰性
N-DSF-L	名詞，間接受格，單數，陰性，地名
N-DSF-LG	名詞，間接受格，單數，陰性，非猶太地名
N-DSF-P	名詞，間接受格，單數，陰性，人名
N-DSF-T	名詞，間接受格，單數，陰性，稱謂
N-DSM	名詞，間接受格，單數，陽性
N-DSM-L	名詞，間接受格，單數，陽性，地名
N-DSM-LG	名詞，間接受格，單數，陽性，非猶太地名
N-DSM-P	名詞，間接受格，單數，陽性，人名
N-DSM-T	名詞，間接受格，單數，陽性，稱謂
N-DSN	名詞，間接受格，單數，中性
N-DSN-L	名詞，間接受格，單數，中性，地名
N-GMP	名詞，所有格，陽性，附屬質詞
N-GPF	名詞，所有格，複數，陰性
N-GPF-L	名詞，所有格，複數，陰性，地名
N-GPF-LG	名詞，所有格，複數，陰性，非猶太地名
N-GPM	名詞，所有格，複數，陽性
N-GPM-L	名詞，所有格，複數，陽性，地名
N-GPM-LG	名詞，所有格，複數，陽性，非猶太地名
N-GPM-PG	名詞，所有格，複數，陽性，非猶太人名
N-GPM-T	名詞，所有格，複數，陽性，稱謂
N-GPN	名詞，所有格，複數，中性
N-GPN-L	名詞，所有格，複數，中性，地名
N-GSF	名詞，所有格，單數，陰性
N-GSF-L	名詞，所有格，單數，陰性，地名
N-GSF-LG	名詞，所有格，單數，陰性，非猶太地名
N-GSF-P	名詞，所有格，單數，陰性，人名
N-GSF-T	名詞，所有格，單數，陰性，稱謂
N-GSM	名詞，所有格，單數，陽性
N-GSM-L	名詞，所有格，單數，陽性，地名
N-GSM-LG	名詞，所有格，單數，陽性，非猶太地名
N-GSM-P	名詞，所有格，單數，陽性，人名
N-GSM-PG	名詞，所有格，單數，陽性，非猶太人名
N-GSM-T	名詞，所有格，單數，陽性，稱謂
N-GSN	名詞，所有格，單數，中性
N-GSN-L	名詞，所有格，單數，中性，地名
N-LI	無變格字母（名詞）
N-NAM	名詞，主格
N-NPF	名詞，主格，複數，陰性
N-NPM	名詞，主格，複數，陽性
N-NPM-L	名詞，主格，複數，陽性，地名
N-NPM-LG	名詞，主格，複數，陽性，非猶太地名
N-NPM-PG	名詞，主格，複數，陽性，非猶太人名
N-NPM-S	名詞，主格，複數，陽性，最上級
N-NPM-T	名詞，主格，複數，陽性，稱謂
N-NPN	名詞，主格，複數，中性
N-NPN-L	名詞，主格，複數，中性，地名
N-NPN-T	名詞，主格，複數，中性，稱謂
N-NSF	名詞，主格，單數，陰性
N-NSF-L	名詞，主格，單數，陰性，地名
N-NSF-LG	名詞，主格，單數，陰性，非猶太地名
N-NSF-P	名詞，主格，單數，陰性，人名
N-NSF-T	名詞，主格，單數，陰性，稱謂
N-NSM	名詞，主格，單數，陽性
N-NSM-C	名詞，主格，單數，陽性，比較級
N-NSM-L	名詞，主格，單數，陽性，地名
N-NSM-LG	名詞，主格，單數，陽性，非猶太地名
N-NSM-P	名詞，主格，單數，陽性，人名
N-NSM-PG	名詞，主格，單數，陽性，非猶太人名
N-NSM-T	名詞，主格，單數，陽性，稱謂
N-NSN	名詞，主格，單數，中性
N-NSN-C	名詞，主格，單數，中性，縮略形式
N-NSN-L	名詞，主格，單數，中性，地名
N-NSN-LI	名詞，主格，單數，中性，無變格字母（名詞）
N-NSN-T	名詞，主格，單數，中性，稱謂
N-OI	無變格名詞
N-PRI	無變格專有名詞
N-VPF	名詞，呼格，複數，陰性
N-VPM	名詞，呼格，複數，陽性
N-VPM-LG	名詞，呼格，複數，陽性，非猶太地名
N-VPM-PG	名詞，呼格，複數，陽性，非猶太人名
N-VPM-T	名詞，呼格，複數，陽性，稱謂
N-VPN	名詞，呼格，複數，中性
N-VSF	名詞，呼格，單數，陰性
N-VSF-L	名詞，呼格，單數，陰性，地名
N-VSF-P	名詞，呼格，單數，陰性，人名
N-VSM	名詞，呼格，單數，陽性
N-VSM-L	名詞，呼格，單數，陽性，地名
N-VSM-P	名詞，呼格，單數，陽性，人名
N-VSM-T	名詞，呼格，單數，陽性，稱謂
N-VSN	名詞，呼格，單數，中性
P-1AP	人稱代名詞，第一人稱，直接受詞，複數
P-1AS	人稱代名詞，第一人稱，直接受詞，單數
P-1AS-C	人稱代名詞，第一人稱，直接受詞，單數，縮略形式
P-1AS-K	人稱代名詞，第一人稱，直接受詞，單數，Kai
P-1DP	人稱代名詞，第一人稱，間接受格，複數
P-1DS	人稱代名詞，第一人稱，間接受格，單數
P-1DS-C	人稱代名詞，第一人稱，間接受格，單數，縮略形式
P-1DS-K	人稱代名詞，第一人稱，間接受格，單數，Kai
P-1GP	人稱代名詞，第一人稱，所有格，複數
P-1GS	人稱代名詞，第一人稱，所有格，單數
P-1NP	人稱代名詞，第一人稱，主格，複數
P-1NS	人稱代名詞，第一人稱，主格，單數
P-1NS-C	人稱代名詞，第一人稱，主格，單數，縮略形式
P-1NS-K	人稱代名詞，第一人稱，主格，單數，Kai
P-2AP	人稱代名詞，第二人稱，直接受詞，複數
P-2AS	人稱代名詞，第二人稱，直接受詞，單數
P-2DP	人稱代名詞，第二人稱，間接受格，複數
P-2DS	人稱代名詞，第二人稱，間接受格，單數
P-2GP	人稱代名詞，第二人稱，所有格，複數
P-2GS	人稱代名詞，第二人稱，所有格，單數
P-2NP	人稱代名詞，第二人稱，主格，複數
P-2NS	人稱代名詞，第二人稱，主格，單數
P-APF	人稱代名詞，直接受詞，複數，陰性
P-APM	人稱代名詞，直接受詞，複數，陽性
P-APN	人稱代名詞，直接受詞，複數，中性
P-ASF	人稱代名詞，直接受詞，單數，陰性
P-ASM	人稱代名詞，直接受詞，單數，陽性
P-ASN	人稱代名詞，直接受詞，單數，中性
P-DPF	人稱代名詞，間接受格，複數，陰性
P-DPM	人稱代名詞，間接受格，複數，陽性
P-DPN	人稱代名詞，間接受格，複數，中性
P-DSF	人稱代名詞，間接受格，單數，陰性
P-DSM	人稱代名詞，間接受格，單數，陽性
P-DSN	人稱代名詞，間接受格，單數，中性
P-GPF	人稱代名詞，所有格，複數，陰性
P-GPM	人稱代名詞，所有格，複數，陽性
P-GPN	人稱代名詞，所有格，複數，中性
P-GSF	人稱代名詞，所有格，單數，陰性
P-GSM	人稱代名詞，所有格，單數，陽性
P-GSN	人稱代名詞，所有格，單數，中性
P-NPM	人稱代名詞，主格，複數，陽性
P-NPN	人稱代名詞，主格，複數，中性
P-NSF	人稱代名詞，主格，單數，陰性
P-NSM	人稱代名詞，主格，單數，陽性
P-NSN	人稱代名詞，主格，單數，中性
PREP	介詞
PRT	質詞，反意質詞
PRT-I	質詞，疑問詞
PRT-N	質詞，否定詞
Q-APF	相關或疑問代名詞，直接受詞，複數，陰性
Q-APM	相關或疑問代名詞，直接受詞，複數，陽性
Q-APN	相關或疑問代名詞，直接受詞，複數，中性
Q-ASF	相關或疑問代名詞，直接受詞，單數，陰性
Q-ASN	相關或疑問代名詞，直接受詞，單數，中性
Q-DSN	相關或疑問代名詞，間接受格，單數，中性
Q-GPF	相關或疑問代名詞，所有格，複數，陰性
Q-GPN	相關或疑問代名詞，所有格，複數，中性
Q-NPF	相關或疑問代名詞，主格，複數，陰性
Q-NPM	相關或疑問代名詞，主格，複數，陽性
Q-NSM	相關或疑問代名詞，主格，單數，陽性
Q-NSN	相關或疑問代名詞，主格，單數，中性
R-APF	關係代名詞，直接受詞，複數，陰性
R-APM	關係代名詞，直接受詞，複數，陽性
R-APN	關係代名詞，直接受詞，複數，中性
R-ASF	關係代名詞，直接受詞，單數，陰性
R-ASM	關係代名詞，直接受詞，單數，陽性
R-ASM-P	關係代名詞，直接受詞，單數，陽性，附屬質詞
R-ASN	關係代名詞，直接受詞，單數，中性
R-DPF	關係代名詞，間接受格，複數，陰性
R-DPM	關係代名詞，間接受格，複數，陽性
R-DPN	關係代名詞，間接受格，複數，中性
R-DSF	關係代名詞，間接受格，單數，陰性
R-DSM	關係代名詞，間接受格，單數，陽性
R-DSN	關係代名詞，間接受格，單數，中性
R-GPF	關係代名詞，所有格，複數，陰性
R-GPM	關係代名詞，所有格，複數，陽性
R-GPN	關係代名詞，所有格，複數，中性
R-GSF	關係代名詞，所有格，單數，陰性
R-GSM	關係代名詞，所有格，單數，陽性
R-GSN	關係代名詞，所有格，單數，中性
R-GSN-ATT	關係代名詞，所有格，單數，中性，阿提卡希臘語
R-NPF	關係代名詞，主格，複數，陰性
R-NPM	關係代名詞，主格，複數，陽性
R-NPN	關係代名詞，主格，複數，中性
R-NSF	關係代名詞，主格，單數，陰性
R-NSM	關係代名詞，主格，單數，陽性
R-NSN	關係代名詞，主格，單數，中性
S-1APF	所有代名詞，第一人稱，直接受詞，複數，陰性
S-1APM	所有代名詞，第一人稱，直接受詞，複數，陽性
S-1APN	所有代名詞，第一人稱，直接受詞，複數，中性
S-1ASF	所有代名詞，第一人稱，直接受詞，單數，陰性
S-1ASM	所有代名詞，第一人稱，直接受詞，單數，陽性
S-1ASN	所有代名詞，第一人稱，直接受詞，單數，中性
S-1DPF	所有代名詞，第一人稱，間接受格，複數，陰性
S-1DPM	所有代名詞，第一人稱，間接受格，複數，陽性
S-1DPN	所有代名詞，第一人稱，間接受格，複數，中性
S-1DSF	所有代名詞，第一人稱，間接受格，單數，陰性
S-1DSM	所有代名詞，第一人稱，間接受格，單數，陽性
S-1DSN	所有代名詞，第一人稱，間接受格，單數，中性
S-1GPF	所有代名詞，第一人稱，所有格，複數，陰性
S-1GPN	所有代名詞，第一人稱，所有格，複數，中性
S-1GSF	所有代名詞，第一人稱，所有格，單數，陰性
S-1NPF	所有代名詞，第一人稱，主格，複數，陰性
S-1NPM	所有代名詞，第一人稱，主格，複數，陽性
S-1NPN	所有代名詞，第一人稱，主格，複數，中性
S-1NSF	所有代名詞，第一人稱，主格，單數，陰性
S-1NSM	所有代名詞，第一人稱，主格，單數，陽性
S-1NSN	所有代名詞，第一人稱，主格，單數，中性
S-1PASF	所有代名詞，第一人稱，複數，直接受詞，單數，陰性
S-1PASN	所有代名詞，第一人稱，複數，直接受詞，單數，中性
S-1PDPF	所有代名詞，第一人稱，複數，間接受格，複數，陰性
S-1PDPM	所有代名詞，第一人稱，複數，間接受格，複數，陽性
S-1PGPF	所有代名詞，第一人稱，複數，所有格，複數，陰性
S-1PGSF	所有代名詞，第一人稱，複數，所有格，單數，陰性
S-1PNPM	所有代名詞，第一人稱，複數，主格，複數，陽性
S-1PNSF	所有代名詞，第一人稱，複數，主格，單數，陰性
S-1SAPF	所有代名詞，第一人稱，單數，直接受詞，複數，陰性
S-1SAPM	所有代名詞，第一人稱，單數，直接受詞，複數，陽性
S-1SAPN	所有代名詞，第一人稱，單數，直接受詞，複數，中性
S-1SASF	所有代名詞，第一人稱，單數，直接受詞，單數，陰性
S-1SASM	所有代名詞，第一人稱，單數，直接受詞，單數，陽性
S-1SASN	所有代名詞，第一人稱，單數，直接受詞，單數，中性
S-1SDPN	所有代名詞，第一人稱，單數，間接受格，複數，中性
S-1SDSF	所有代名詞，第一人稱，單數，間接受格，單數，陰性
S-1SDSM	所有代名詞，第一人稱，單數，間接受格，單數，陽性
S-1SDSN	所有代名詞，第一人稱，單數，間接受格，單數，中性
S-1SGPN	所有代名詞，第一人稱，單數，所有格，複數，中性
S-1SGSF	所有代名詞，第一人稱，單數，所有格，單數，陰性
S-1SGSN	所有代名詞，第一人稱，單數，所有格，單數，中性
S-1SNPM	所有代名詞，第一人稱，單數，主格，複數，陽性
S-1SNPN	所有代名詞，第一人稱，單數，主格，複數，中性
S-1SNSF	所有代名詞，第一人稱，單數，主格，單數，陰性
S-1SNSM	所有代名詞，第一人稱，單數，主格，單數，陽性
S-1SNSN	所有代名詞，第一人稱，單數，主格，單數，中性
S-2APF	所有代名詞，第二人稱，直接受詞，複數，陰性
S-2APM	所有代名詞，第二人稱，直接受詞，複數，陽性
S-2APN	所有代名詞，第二人稱，直接受詞，複數，中性
S-2ASF	所有代名詞，第二人稱，直接受詞，單數，陰性
S-2ASN	所有代名詞，第二人稱，直接受詞，單數，中性
S-2DPF	所有代名詞，第二人稱，間接受格，複數，陰性
S-2DPM	所有代名詞，第二人稱，間接受格，複數，陽性
S-2DSF	所有代名詞，第二人稱，間接受格，單數，陰性
S-2DSM	所有代名詞，第二人稱，間接受格，單數，陽性
S-2GPF	所有代名詞，第二人稱，所有格，複數，陰性
S-2GSF	所有代名詞，第二人稱，所有格，單數，陰性
S-2NPF	所有代名詞，第二人稱，主格，複數，陰性
S-2NPM	所有代名詞，第二人稱，主格，複數，陽性
S-2NPN	所有代名詞，第二人稱，主格，複數，中性
S-2NSM	所有代名詞，第二人稱，主格，單數，陽性
S-2NSN	所有代名詞，第二人稱，主格，單數，中性
S-2PASF	所有代名詞，第二人稱，複數，直接受詞，單數，陰性
S-2PASM	所有代名詞，第二人稱，複數，直接受詞，單數，陽性
S-2PASN	所有代名詞，第二人稱，複數，直接受詞，單數，中性
S-2PDSF	所有代名詞，第二人稱，複數，間接受格，單數，陰性
S-2PDSM	所有代名詞，第二人稱，複數，間接受格，單數，陽性
S-2PDSN	所有代名詞，第二人稱，複數，間接受格，單數，中性
S-2PGSF	所有代名詞，第二人稱，複數，所有格，單數，陰性
S-2PNSF	所有代名詞，第二人稱，複數，主格，單數，陰性
S-2PNSM	所有代名詞，第二人稱，複數，主格，單數，陽性
S-2SAPM	所有代名詞，第二人稱，單數，直接受詞，複數，陽性
S-2SAPN	所有代名詞，第二人稱，單數，直接受詞，複數，中性
S-2SASF	所有代名詞，第二人稱，單數，直接受詞，單數，陰性
S-2SASN	所有代名詞，第二人稱，單數，直接受詞，單數，中性
S-2SDSF	所有代名詞，第二人稱，單數，間接受格，單數，陰性
S-2SDSM	所有代名詞，第二人稱，單數，間接受格，單數，陽性
S-2SDSN	所有代名詞，第二人稱，單數，間接受格，單數，中性
S-2SGSF	所有代名詞，第二人稱，單數，所有格，單數，陰性
S-2SNPM	所有代名詞，第二人稱，單數，主格，複數，陽性
S-2SNPN	所有代名詞，第二人稱，單數，主格，複數，中性
S-2SNSM	所有代名詞，第二人稱，單數，主格，單數，陽性
S-2SNSN	所有代名詞，第二人稱，單數，主格，單數，中性
T-APF	冠詞，直接受詞，複數，陰性
T-APM	冠詞，直接受詞，複數，陽性
T-APN	冠詞，直接受詞，複數，中性
T-ASF	冠詞，直接受詞，單數，陰性
T-ASM	冠詞，直接受詞，單數，陽性
T-ASN	冠詞，直接受詞，單數，中性
T-DPF	冠詞，間接受格，複數，陰性
T-DPM	冠詞，間接受格，複數，陽性
T-DPN	冠詞，間接受格，複數，中性
T-DSF	冠詞，間接受格，單數，陰性
T-DSM	冠詞，間接受格，單數，陽性
T-DSN	冠詞，間接受格，單數，中性
T-GPF	冠詞，所有格，複數，陰性
T-GPM	冠詞，所有格，複數，陽性
T-GPN	冠詞，所有格，複數，中性
T-GSF	冠詞，所有格，單數，陰性
T-GSM	冠詞，所有格，單數，陽性
T-GSN	冠詞，所有格，單數，中性
T-NPF	冠詞，主格，複數，陰性
T-NPM	冠詞，主格，複數，陽性
T-NPN	冠詞，主格，複數，中性
T-NSF	冠詞，主格，單數，陰性
T-NSM	冠詞，主格，單數，陽性
T-NSN	冠詞，主格，單數，中性
T-VPF	冠詞，呼格，複數，陰性
T-VPM	冠詞，呼格，複數，陽性
T-VPN	冠詞，呼格，複數，中性
T-VSF	冠詞，呼格，單數，陰性
T-VSM	冠詞，呼格，單數，陽性
T-VSN	冠詞，呼格，單數，中性
V-2AAI-1P	動詞，第二簡單過去時態，主動，直說語氣，第一人稱，複數
V-2AAI-1S	動詞，第二簡單過去時態，主動，直說語氣，第一人稱，單數
V-2AAI-2P	動詞，第二簡單過去時態，主動，直說語氣，第二人稱，複數
V-2AAI-2S	動詞，第二簡單過去時態，主動，直說語氣，第二人稱，單數
V-2AAI-3P	動詞，第二簡單過去時態，主動，直說語氣，第三人稱，複數
V-2AAI-3P-ATT	動詞，第二簡單過去時態，主動，直說語氣，第三人稱，複數，阿提卡形式
V-2AAI-3S	動詞，第二簡單過去時態，主動，直說語氣，第三人稱，單數
V-2AAM-2P	動詞，第二簡單過去時態，主動，命令語氣，第二人稱，複數
V-2AAM-2S	動詞，第二簡單過去時態，主動，命令語氣，第二人稱，單數
V-2AAM-2S-AP	動詞，第二簡單過去時態，主動，命令語氣，第二人稱，單數，尾落形式
V-2AAM-2S-ATT	動詞，第二簡單過去時態，主動，命令語氣，第二人稱，單數，阿提卡形式
V-2AAM-3P	動詞，第二簡單過去時態，主動，命令語氣，第三人稱，複數
V-2AAM-3S	動詞，第二簡單過去時態，主動，命令語氣，第三人稱，單數
V-2AAN	動詞，第二簡單過去時態，主動，不定語氣
V-2AAO-3P	動詞，第二簡單過去時態，主動，祈願語氣，第三人稱，複數
V-2AAO-3S	動詞，第二簡單過去時態，主動，祈願語氣，第三人稱，單數
V-2AAP-APF	動詞，第二簡單過去時態，主動，分詞，直接受詞，複數，陰性
V-2AAP-APM	動詞，第二簡單過去時態，主動，分詞，直接受詞，複數，陽性
V-2AAP-ASF	動詞，第二簡單過去時態，主動，分詞，直接受詞，單數，陰性
V-2AAP-ASM	動詞，第二簡單過去時態，主動，分詞，直接受詞，單數，陽性
V-2AAP-ASN	動詞，第二簡單過去時態，主動，分詞，直接受詞，單數，中性
V-2AAP-DPF	動詞，第二簡單過去時態，主動，分詞，間接受格，複數，陰性
V-2AAP-DPM	動詞，第二簡單過去時態，主動，分詞，間接受格，複數，陽性
V-2AAP-DSF	動詞，第二簡單過去時態，主動，分詞，間接受格，單數，陰性
V-2AAP-DSM	動詞，第二簡單過去時態，主動，分詞，間接受格，單數，陽性
V-2AAP-GPM	動詞，第二簡單過去時態，主動，分詞，所有格，複數，陽性
V-2AAP-GSF	動詞，第二簡單過去時態，主動，分詞，所有格，單數，陰性
V-2AAP-GSM	動詞，第二簡單過去時態，主動，分詞，所有格，單數，陽性
V-2AAP-GSN	動詞，第二簡單過去時態，主動，分詞，所有格，單數，中性
V-2AAP-NPF	動詞，第二簡單過去時態，主動，分詞，主格，複數，陰性
V-2AAP-NPM	動詞，第二簡單過去時態，主動，分詞，主格，複數，陽性
V-2AAP-NPN	動詞，第二簡單過去時態，主動，分詞，主格，複數，中性
V-2AAP-NSF	動詞，第二簡單過去時態，主動，分詞，主格，單數，陰性
V-2AAP-NSM	動詞，第二簡單過去時態，主動，分詞，主格，單數，陽性
V-2AAP-NSN	動詞，第二簡單過去時態，主動，分詞，主格，單數，中性
V-2AAS-1P	動詞，第二簡單過去時態，主動，假設語氣，第一人稱，複數
V-2AAS-1S	動詞，第二簡單過去時態，主動，假設語氣，第一人稱，單數
V-2AAS-2P	動詞，第二簡單過去時態，主動，假設語氣，第二人稱，複數
V-2AAS-2S	動詞，第二簡單過去時態，主動，假設語氣，第二人稱，單數
V-2AAS-3P	動詞，第二簡單過去時態，主動，假設語氣，第三人稱，複數
V-2AAS-3S	動詞，第二簡單過去時態，主動，假設語氣，第三人稱，單數
V-2ADI-1S	動詞，第二簡單過去時態，關身形主動意，直說語氣，第一人稱，單數
V-2ADI-2P	動詞，第二簡單過去時態，關身形主動意，直說語氣，第二人稱，複數
V-2ADI-2S	動詞，第二簡單過去時態，關身形主動意，直說語氣，第二人稱，單數
V-2ADI-3P	動詞，第二簡單過去時態，關身形主動意，直說語氣，第三人稱，複數
V-2ADI-3S	動詞，第二簡單過去時態，關身形主動意，直說語氣，第三人稱，單數
V-2ADM-2P	動詞，第二簡單過去時態，關身形主動意，命令語氣，第二人稱，複數
V-2ADM-2S	動詞，第二簡單過去時態，關身形主動意，命令語氣，第二人稱，單數
V-2ADM-3S	動詞，第二簡單過去時態，關身形主動意，命令語氣，第三人稱，單數
V-2ADN	動詞，第二簡單過去時態，關身形主動意，不定語氣
V-2ADO-1S	動詞，第二簡單過去時態，關身形主動意，祈願語氣，第一人稱，單數
V-2ADO-3S	動詞，第二簡單過去時態，關身形主動意，祈願語氣，第三人稱，單數
V-2ADP-APM	動詞，第二簡單過去時態，關身形主動意，分詞，直接受詞，複數，陽性
V-2ADP-APN	動詞，第二簡單過去時態，關身形主動意，分詞，直接受詞，複數，中性
V-2ADP-ASF	動詞，第二簡單過去時態，關身形主動意，分詞，直接受詞，單數，陰性
V-2ADP-ASM	動詞，第二簡單過去時態，關身形主動意，分詞，直接受詞，單數，陽性
V-2ADP-ASN	動詞，第二簡單過去時態，關身形主動意，分詞，直接受詞，單數，中性
V-2ADP-DPM	動詞，第二簡單過去時態，關身形主動意，分詞，間接受格，複數，陽性
V-2ADP-DPN	動詞，第二簡單過去時態，關身形主動意，分詞，間接受格，複數，中性
V-2ADP-GPF	動詞，第二簡單過去時態，關身形主動意，分詞，所有格，複數，陰性
V-2ADP-GPM	動詞，第二簡單過去時態，關身形主動意，分詞，所有格，複數，陽性
V-2ADP-GPN	動詞，第二簡單過去時態，關身形主動意，分詞，所有格，複數，中性
V-2ADP-GSF	動詞，第二簡單過去時態，關身形主動意，分詞，所有格，單數，陰性
V-2ADP-GSM	動詞，第二簡單過去時態，關身形主動意，分詞，所有格，單數，陽性
V-2ADP-GSN	動詞，第二簡單過去時態，關身形主動意，分詞，所有格，單數，中性
V-2ADP-NPF	動詞，第二簡單過去時態，關身形主動意，分詞，主格，複數，陰性
V-2ADP-NPM	動詞，第二簡單過去時態，關身形主動意，分詞，主格，複數，陽性
V-2ADP-NSM	動詞，第二簡單過去時態，關身形主動意，分詞，主格，單數，陽性
V-2ADS-1P	動詞，第二簡單過去時態，關身形主動意，假設語氣，第一人稱，複數
V-2ADS-1S	動詞，第二簡單過去時態，關身形主動意，假設語氣，第一人稱，單數
V-2ADS-2P	動詞，第二簡單過去時態，關身形主動意，假設語氣，第二人稱，複數
V-2ADS-3P	動詞，第二簡單過去時態，關身形主動意，假設語氣，第三人稱，複數
V-2ADS-3S	動詞，第二簡單過去時態，關身形主動意，假設語氣，第三人稱，單數
V-2AMI-1P	動詞，第二簡單過去時態，關身語態，直說語氣，第一人稱，複數
V-2AMI-1S	動詞，第二簡單過去時態，關身語態，直說語氣，第一人稱，單數
V-2AMI-2P	動詞，第二簡單過去時態，關身語態，直說語氣，第二人稱，複數
V-2AMI-2S	動詞，第二簡單過去時態，關身語態，直說語氣，第二人稱，單數
V-2AMI-3P	動詞，第二簡單過去時態，關身語態，直說語氣，第三人稱，複數
V-2AMI-3S	動詞，第二簡單過去時態，關身語態，直說語氣，第三人稱，單數
V-2AMM-2P	動詞，第二簡單過去時態，關身語態，命令語氣，第二人稱，複數
V-2AMM-2S	動詞，第二簡單過去時態，關身語態，命令語氣，第二人稱，單數
V-2AMN	動詞，第二簡單過去時態，關身語態，不定語氣
V-2AMP-GSM	動詞，第二簡單過去時態，關身語態，分詞，所有格，單數，陽性
V-2AMP-NPM	動詞，第二簡單過去時態，關身語態，分詞，主格，複數，陽性
V-2AMP-NSM	動詞，第二簡單過去時態，關身語態，分詞，主格，單數，陽性
V-2AMS-1P	動詞，第二簡單過去時態，關身語態，假設語氣，第一人稱，複數
V-2AMS-1S	動詞，第二簡單過去時態，關身語態，假設語氣，第一人稱，單數
V-2AMS-2S	動詞，第二簡單過去時態，關身語態，假設語氣，第二人稱，單數
V-2AMS-3P	動詞，第二簡單過去時態，關身語態，假設語氣，第三人稱，複數
V-2AMS-3S	動詞，第二簡單過去時態，關身語態，假設語氣，第三人稱，單數
V-2AOI-1P	動詞，第二簡單過去時態，被動形主動意，直說語氣，第一人稱，複數
V-2AOI-1S	動詞，第二簡單過去時態，被動形主動意，直說語氣，第一人稱，單數
V-2AOI-2P	動詞，第二簡單過去時態，被動形主動意，直說語氣，第二人稱，複數
V-2AOI-3P	動詞，第二簡單過去時態，被動形主動意，直說語氣，第三人稱，複數
V-2AOI-3S	動詞，第二簡單過去時態，被動形主動意，直說語氣，第三人稱，單數
V-2AOM-2P	動詞，第二簡單過去時態，被動形主動意，命令語氣，第二人稱，複數
V-2AON	動詞，第二簡單過去時態，被動形主動意，不定語氣
V-2AOS-2P	動詞，第二簡單過去時態，被動形主動意，假設語氣，第二人稱，複數
V-2API-1P	動詞，第二簡單過去時態，被動語態，直說語氣，第一人稱，複數
V-2API-1S	動詞，第二簡單過去時態，被動語態，直說語氣，第一人稱，單數
V-2API-2P	動詞，第二簡單過去時態，被動語態，直說語氣，第二人稱，複數
V-2API-2S	動詞，第二簡單過去時態，被動語態，直說語氣，第二人稱，單數
V-2API-3P	動詞，第二簡單過去時態，被動語態，直說語氣，第三人稱，複數
V-2API-3S	動詞，第二簡單過去時態，被動語態，直說語氣，第三人稱，單數
V-2APM-2P	動詞，第二簡單過去時態，被動語態，命令語氣，第二人稱，複數
V-2APM-2S	動詞，第二簡單過去時態，被動語態，命令語氣，第二人稱，單數
V-2APM-3S	動詞，第二簡單過去時態，被動語態，命令語氣，第三人稱，單數
V-2APN	動詞，第二簡單過去時態，被動語態，不定語氣
V-2APP-ASM	動詞，第二簡單過去時態，被動語態，分詞，直接受詞，單數，陽性
V-2APP-DSN	動詞，第二簡單過去時態，被動語態，分詞，間接受格，單數，中性
V-2APP-GPM	動詞，第二簡單過去時態，被動語態，分詞，所有格，複數，陽性
V-2APP-NPF	動詞，第二簡單過去時態，被動語態，分詞，主格，複數，陰性
V-2APP-NPM	動詞，第二簡單過去時態，被動語態，分詞，主格，複數，陽性
V-2APP-NSF	動詞，第二簡單過去時態，被動語態，分詞，主格，單數，陰性
V-2APP-NSM	動詞，第二簡單過去時態，被動語態，分詞，主格，單數，陽性
V-2APP-NSN	動詞，第二簡單過去時態，被動語態，分詞，主格，單數，中性
V-2APS-1P	動詞，第二簡單過去時態，被動語態，假設語氣，第一人稱，複數
V-2APS-2P	動詞，第二簡單過去時態，被動語態，假設語氣，第二人稱，複數
V-2APS-2S	動詞，第二簡單過去時態，被動語態，假設語氣，第二人稱，單數
V-2APS-3P	動詞，第二簡單過去時態，被動語態，假設語氣，第三人稱，複數
V-2APS-3S	動詞，第二簡單過去時態，被動語態，假設語氣，第三人稱，單數
V-2AXM-2P	動詞，第二簡單過去時態，無指定語態，命令語氣，第二人稱，複數
V-2AXP-GPM	動詞，第二簡單過去時態，無指定語態，分詞，所有格，複數，陽性
V-2AXS-2P	動詞，第二簡單過去時態，無指定語態，假設語氣，第二人稱，複數
V-2FAI-1S	動詞，第二未來時態，主動，直說語氣，第一人稱，單數
V-2FAI-3S	動詞，第二未來時態，主動，直說語氣，第三人稱，單數
V-2FDI-2S	動詞，第二未來時態，關身形主動意，直說語氣，第二人稱，單數
V-2FDI-3P	動詞，第二未來時態，關身形主動意，直說語氣，第三人稱，複數
V-2FDI-3S	動詞，第二未來時態，關身形主動意，直說語氣，第三人稱，單數
V-2FMI-3S	動詞，第二未來時態，關身語態，直說語氣，第三人稱，單數
V-2FOI-1S	動詞，第二未來時態，被動形主動意，直說語氣，第一人稱，單數
V-2FOI-3P	動詞，第二未來時態，被動形主動意，直說語氣，第三人稱，複數
V-2FOI-3S	動詞，第二未來時態，被動形主動意，直說語氣，第三人稱，單數
V-2FPI-1P	動詞，第二未來時態，被動語態，直說語氣，第一人稱，複數
V-2FPI-2P	動詞，第二未來時態，被動語態，直說語氣，第二人稱，複數
V-2FPI-2S	動詞，第二未來時態，被動語態，直說語氣，第二人稱，單數
V-2FPI-3P	動詞，第二未來時態，被動語態，直說語氣，第三人稱，複數
V-2FPI-3S	動詞，第二未來時態，被動語態，直說語氣，第三人稱，單數
V-2LAI-1S	動詞，第二過去完成時態，主動，直說語氣，第一人稱，單數
V-2LAI-2P	動詞，第二過去完成時態，主動，直說語氣，第二人稱，複數
V-2LAI-2S	動詞，第二過去完成時態，主動，直說語氣，第二人稱，單數
V-2LAI-3P	動詞，第二過去完成時態，主動，直說語氣，第三人稱，複數
V-2LAI-3S	動詞，第二過去完成時態，主動，直說語氣，第三人稱，單數
V-2PAI-2S	動詞，第二現在進行時態，主動，直說語氣，第二人稱，單數
V-2PAN	動詞，第二現在進行時態，主動，不定語氣
V-2RAI-1P	動詞，第二現在完成時態，主動，直說語氣，第一人稱，複數
V-2RAI-1P-ATT	動詞，第二現在完成時態，主動，直說語氣，第一人稱，複數，阿提卡形式
V-2RAI-1S	動詞，第二現在完成時態，主動，直說語氣，第一人稱，單數
V-2RAI-2P	動詞，第二現在完成時態，主動，直說語氣，第二人稱，複數
V-2RAI-2P-ATT	動詞，第二現在完成時態，主動，直說語氣，第二人稱，複數，阿提卡形式
V-2RAI-2S	動詞，第二現在完成時態，主動，直說語氣，第二人稱，單數
V-2RAI-3P	動詞，第二現在完成時態，主動，直說語氣，第三人稱，複數
V-2RAI-3P-ATT	動詞，第二現在完成時態，主動，直說語氣，第三人稱，複數，阿提卡形式
V-2RAI-3P-C	動詞，第二現在完成時態，主動，直說語氣，第三人稱，複數，縮略形式
V-2RAI-3S	動詞，第二現在完成時態，主動，直說語氣，第三人稱，單數
V-2RAI-3S-ATT	動詞，第二現在完成時態，主動，直說語氣，第三人稱，單數，阿提卡形式
V-2RAN	動詞，第二現在完成時態，主動，不定語氣
V-2RAP-APM	動詞，第二現在完成時態，主動，分詞，直接受詞，複數，陽性
V-2RAP-APM-ATT	動詞，第二現在完成時態，主動，分詞，直接受詞，複數，陽性，阿提卡形式
V-2RAP-APN	動詞，第二現在完成時態，主動，分詞，直接受詞，複數，中性
V-2RAP-ASF	動詞，第二現在完成時態，主動，分詞，直接受詞，單數，陰性
V-2RAP-ASM	動詞，第二現在完成時態，主動，分詞，直接受詞，單數，陽性
V-2RAP-ASN	動詞，第二現在完成時態，主動，分詞，直接受詞，單數，中性
V-2RAP-DSN	動詞，第二現在完成時態，主動，分詞，間接受格，單數，中性
V-2RAP-GPN	動詞，第二現在完成時態，主動，分詞，所有格，複數，中性
V-2RAP-NPF	動詞，第二現在完成時態，主動，分詞，主格，複數，陰性
V-2RAP-NPM	動詞，第二現在完成時態，主動，分詞，主格，複數，陽性
V-2RAP-NSF	動詞，第二現在完成時態，主動，分詞，主格，單數，陰性
V-2RAP-NSM	動詞，第二現在完成時態，主動，分詞，主格，單數，陽性
V-2RAP-NSN	動詞，第二現在完成時態，主動，分詞，主格，單數，中性
V-2RPP-APF	動詞，第二現在完成時態，被動語態，分詞，直接受詞，複數，陰性
V-2RPP-ASM	動詞，第二現在完成時態，被動語態，分詞，直接受詞，單數，陽性
V-2RPP-ASN	動詞，第二現在完成時態，被動語態，分詞，直接受詞，單數，中性
V-2RPP-GSF	動詞，第二現在完成時態，被動語態，分詞，所有格，單數，陰性
V-2RPP-NSM	動詞，第二現在完成時態，被動語態，分詞，主格，單數，陽性
V-AAI-1P	動詞，簡單過去時態，主動，直說語氣，第一人稱，複數
V-AAI-1S	動詞，簡單過去時態，主動，直說語氣，第一人稱，單數
V-AAI-2P	動詞，簡單過去時態，主動，直說語氣，第二人稱，複數
V-AAI-2S	動詞，簡單過去時態，主動，直說語氣，第二人稱，單數
V-AAI-3P	動詞，簡單過去時態，主動，直說語氣，第三人稱，複數
V-AAI-3S	動詞，簡單過去時態，主動，直說語氣，第三人稱，單數
V-AAM-2P	動詞，簡單過去時態，主動，命令語氣，第二人稱，複數
V-AAM-2S	動詞，簡單過去時態，主動，命令語氣，第二人稱，單數
V-AAM-3P	動詞，簡單過去時態，主動，命令語氣，第三人稱，複數
V-AAM-3S	動詞，簡單過去時態，主動，命令語氣，第三人稱，單數
V-AAN	動詞，簡單過去時態，主動，不定語氣
V-AAO-3P	動詞，簡單過去時態，主動，祈願語氣，第三人稱，複數
V-AAO-3P-A	動詞，簡單過去時態，主動，祈願語氣，第三人稱，複數，伊歐里斯希臘語
V-AAO-3S	動詞，簡單過去時態，主動，祈願語氣，第三人稱，單數
V-AAP-APM	動詞，簡單過去時態，主動，分詞，直接受詞，複數，陽性
V-AAP-APN	動詞，簡單過去時態，主動，分詞，直接受詞，複數，中性
V-AAP-ASF	動詞，簡單過去時態，主動，分詞，直接受詞，單數，陰性
V-AAP-ASM	動詞，簡單過去時態，主動，分詞，直接受詞，單數，陽性
V-AAP-ASN	動詞，簡單過去時態，主動，分詞，直接受詞，單數，中性
V-AAP-DPM	動詞，簡單過去時態，主動，分詞，間接受格，複數，陽性
V-AAP-DSM	動詞，簡單過去時態，主動，分詞，間接受格，單數，陽性
V-AAP-GPM	動詞，簡單過去時態，主動，分詞，所有格，複數，陽性
V-AAP-GSF	動詞，簡單過去時態，主動，分詞，所有格，單數，陰性
V-AAP-GSM	動詞，簡單過去時態，主動，分詞，所有格，單數，陽性
V-AAP-NPF	動詞，簡單過去時態，主動，分詞，主格，複數，陰性
V-AAP-NPM	動詞，簡單過去時態，主動，分詞，主格，複數，陽性
V-AAP-NSF	動詞，簡單過去時態，主動，分詞，主格，單數，陰性
V-AAP-NSM	動詞，簡單過去時態，主動，分詞，主格，單數，陽性
V-AAP-NSN	動詞，簡單過去時態，主動，分詞，主格，單數，中性
V-AAPNS	動詞，簡單過去時態，主動，分詞，主格，單數
V-AAS-1P	動詞，簡單過去時態，主動，假設語氣，第一人稱，複數
V-AAS-1S	動詞，簡單過去時態，主動，假設語氣，第一人稱，單數
V-AAS-2P	動詞，簡單過去時態，主動，假設語氣，第二人稱，複數
V-AAS-2S	動詞，簡單過去時態，主動，假設語氣，第二人稱，單數
V-AAS-3P	動詞，簡單過去時態，主動，假設語氣，第三人稱，複數
V-AAS-3S	動詞，簡單過去時態，主動，假設語氣，第三人稱，單數
V-ADI-1P	動詞，簡單過去時態，關身形主動意，直說語氣，第一人稱，複數
V-ADI-1S	動詞，簡單過去時態，關身形主動意，直說語氣，第一人稱，單數
V-ADI-2P	動詞，簡單過去時態，關身形主動意，直說語氣，第二人稱，複數
V-ADI-2S	動詞，簡單過去時態，關身形主動意，直說語氣，第二人稱，單數
V-ADI-3P	動詞，簡單過去時態，關身形主動意，直說語氣，第三人稱，複數
V-ADI-3S	動詞，簡單過去時態，關身形主動意，直說語氣，第三人稱，單數
V-ADM-2P	動詞，簡單過去時態，關身形主動意，命令語氣，第二人稱，複數
V-ADM-2S	動詞，簡單過去時態，關身形主動意，命令語氣，第二人稱，單數
V-ADM-3P	動詞，簡單過去時態，關身形主動意，命令語氣，第三人稱，複數
V-ADM-3S	動詞，簡單過去時態，關身形主動意，命令語氣，第三人稱，單數
V-ADN	動詞，簡單過去時態，關身形主動意，不定語氣
V-ADO-1S	動詞，簡單過去時態，關身形主動意，祈願語氣，第一人稱，單數
V-ADP-APM	動詞，簡單過去時態，關身形主動意，分詞，直接受詞，複數，陽性
V-ADP-ASM	動詞，簡單過去時態，關身形主動意，分詞，直接受詞，單數，陽性
V-ADP-DPM	動詞，簡單過去時態，關身形主動意，分詞，間接受格，複數，陽性
V-ADP-GSF	動詞，簡單過去時態，關身形主動意，分詞，所有格，單數，陰性
V-ADP-NPM	動詞，簡單過去時態，關身形主動意，分詞，主格，複數，陽性
V-ADP-NSF	動詞，簡單過去時態，關身形主動意，分詞，主格，單數，陰性
V-ADP-NSM	動詞，簡單過去時態，關身形主動意，分詞，主格，單數，陽性
V-ADS-1P	動詞，簡單過去時態，關身形主動意，假設語氣，第一人稱，複數
V-ADS-1S	動詞，簡單過去時態，關身形主動意，假設語氣，第一人稱，單數
V-ADS-2P	動詞，簡單過去時態，關身形主動意，假設語氣，第二人稱，複數
V-ADS-2S	動詞，簡單過去時態，關身形主動意，假設語氣，第二人稱，單數
V-ADS-3P	動詞，簡單過去時態，關身形主動意，假設語氣，第三人稱，複數
V-ADS-3S	動詞，簡單過去時態，關身形主動意，假設語氣，第三人稱，單數
V-AMI-1P	動詞，簡單過去時態，關身語態，直說語氣，第一人稱，複數
V-AMI-1S	動詞，簡單過去時態，關身語態，直說語氣，第一人稱，單數
V-AMI-2P	動詞，簡單過去時態，關身語態，直說語氣，第二人稱，複數
V-AMI-2S	動詞，簡單過去時態，關身語態，直說語氣，第二人稱，單數
V-AMI-3P	動詞，簡單過去時態，關身語態，直說語氣，第三人稱，複數
V-AMI-3S	動詞，簡單過去時態，關身語態，直說語氣，第三人稱，單數
V-AMM-2P	動詞，簡單過去時態，關身語態，命令語氣，第二人稱，複數
V-AMM-2S	動詞，簡單過去時態，關身語態，命令語氣，第二人稱，單數
V-AMM-3S	動詞，簡單過去時態，關身語態，命令語氣，第三人稱，單數
V-AMN	動詞，簡單過去時態，關身語態，不定語氣
V-AMP-APM	動詞，簡單過去時態，關身語態，分詞，直接受詞，複數，陽性
V-AMP-ASN	動詞，簡單過去時態，關身語態，分詞，直接受詞，單數，中性
V-AMP-DPM	動詞，簡單過去時態，關身語態，分詞，間接受格，複數，陽性
V-AMP-GPM	動詞，簡單過去時態，關身語態，分詞，所有格，複數，陽性
V-AMP-GSM	動詞，簡單過去時態，關身語態，分詞，所有格，單數，陽性
V-AMP-NPM	動詞，簡單過去時態，關身語態，分詞，主格，複數，陽性
V-AMP-NSF	動詞，簡單過去時態，關身語態，分詞，主格，單數，陰性
V-AMP-NSM	動詞，簡單過去時態，關身語態，分詞，主格，單數，陽性
V-AMP-NSN	動詞，簡單過去時態，關身語態，分詞，主格，單數，中性
V-AMPNP	動詞，簡單過去時態，關身語態，分詞，主格，複數
V-AMS-1P	動詞，簡單過去時態，關身語態，假設語氣，第一人稱，複數
V-AMS-1S	動詞，簡單過去時態，關身語態，假設語氣，第一人稱，單數
V-AMS-2P	動詞，簡單過去時態，關身語態，假設語氣，第二人稱，複數
V-AMS-2S	動詞，簡單過去時態，關身語態，假設語氣，第二人稱，單數
V-AMS-3P	動詞，簡單過去時態，關身語態，假設語氣，第三人稱，複數
V-AMS-3S	動詞，簡單過去時態，關身語態，假設語氣，第三人稱，單數
V-ANI-3P	動詞，簡單過去時態，關身形或被動形主動意，直說語氣，第三人稱，複數
V-ANI-3S	動詞，簡單過去時態，關身形或被動形主動意，直說語氣，第三人稱，單數
V-ANP-NSM	動詞，簡單過去時態，關身形或被動形主動意，分詞，主格，單數，陽性
V-ANP-NSN	動詞，簡單過去時態，關身形或被動形主動意，分詞，主格，單數，中性
V-AOI-1P	動詞，簡單過去時態，被動形主動意，直說語氣，第一人稱，複數
V-AOI-1P-ATT	動詞，簡單過去時態，被動形主動意，直說語氣，第一人稱，複數，阿提卡形式
V-AOI-1S	動詞，簡單過去時態，被動形主動意，直說語氣，第一人稱，單數
V-AOI-1S-ATT	動詞，簡單過去時態，被動形主動意，直說語氣，第一人稱，單數，阿提卡形式
V-AOI-2P	動詞，簡單過去時態，被動形主動意，直說語氣，第二人稱，複數
V-AOI-2P-ATT	動詞，簡單過去時態，被動形主動意，直說語氣，第二人稱，複數，阿提卡形式
V-AOI-3P	動詞，簡單過去時態，被動形主動意，直說語氣，第三人稱，複數
V-AOI-3P-ATT	動詞，簡單過去時態，被動形主動意，直說語氣，第三人稱，複數，阿提卡形式
V-AOI-3S	動詞，簡單過去時態，被動形主動意，直說語氣，第三人稱，單數
V-AOI-3S-ATT	動詞，簡單過去時態，被動形主動意，直說語氣，第三人稱，單數，阿提卡形式
V-AOM-2P	動詞，簡單過去時態，被動形主動意，命令語氣，第二人稱，複數
V-AOM-2S	動詞，簡單過去時態，被動形主動意，命令語氣，第二人稱，單數
V-AOM-3S	動詞，簡單過去時態，被動形主動意，命令語氣，第三人稱，單數
V-AON	動詞，簡單過去時態，被動形主動意，不定語氣
V-AOO-3S	動詞，簡單過去時態，被動形主動意，祈願語氣，第三人稱，單數
V-AOP-APM	動詞，簡單過去時態，被動形主動意，分詞，直接受詞，複數，陽性
V-AOP-ASM	動詞，簡單過去時態，被動形主動意，分詞，直接受詞，單數，陽性
V-AOP-DSM	動詞，簡單過去時態，被動形主動意，分詞，間接受格，單數，陽性
V-AOP-GPM	動詞，簡單過去時態，被動形主動意，分詞，所有格，複數，陽性
V-AOP-GPN	動詞，簡單過去時態，被動形主動意，分詞，所有格，複數，中性
V-AOP-GSM	動詞，簡單過去時態，被動形主動意，分詞，所有格，單數，陽性
V-AOP-NPF	動詞，簡單過去時態，被動形主動意，分詞，主格，複數，陰性
V-AOP-NPM	動詞，簡單過去時態，被動形主動意，分詞，主格，複數，陽性
V-AOP-NSF	動詞，簡單過去時態，被動形主動意，分詞，主格，單數，陰性
V-AOP-NSM	動詞，簡單過去時態，被動形主動意，分詞，主格，單數，陽性
V-AOP-NSN	動詞，簡單過去時態，被動形主動意，分詞，主格，單數，中性
V-AOS-1P	動詞，簡單過去時態，被動形主動意，假設語氣，第一人稱，複數
V-AOS-1S	動詞，簡單過去時態，被動形主動意，假設語氣，第一人稱，單數
V-AOS-2P	動詞，簡單過去時態，被動形主動意，假設語氣，第二人稱，複數
V-AOS-2S	動詞，簡單過去時態，被動形主動意，假設語氣，第二人稱，單數
V-AOS-3P	動詞，簡單過去時態，被動形主動意，假設語氣，第三人稱，複數
V-AOS-3S	動詞，簡單過去時態，被動形主動意，假設語氣，第三人稱，單數
V-API	動詞，簡單過去時態，被動語態，直說語氣
V-API-1P	動詞，簡單過去時態，被動語態，直說語氣，第一人稱，複數
V-API-1S	動詞，簡單過去時態，被動語態，直說語氣，第一人稱，單數
V-API-2P	動詞，簡單過去時態，被動語態，直說語氣，第二人稱，複數
V-API-2S	動詞，簡單過去時態，被動語態，直說語氣，第二人稱，單數
V-API-3P	動詞，簡單過去時態，被動語態，直說語氣，第三人稱，複數
V-API-3S	動詞，簡單過去時態，被動語態，直說語氣，第三人稱，單數
V-API-3S-M	動詞，簡單過去時態，被動語態，直說語氣，第三人稱，單數，關身意義
V-APM-2P	動詞，簡單過去時態，被動語態，命令語氣，第二人稱，複數
V-APM-2S	動詞，簡單過去時態，被動語態，命令語氣，第二人稱，單數
V-APM-3P	動詞，簡單過去時態，被動語態，命令語氣，第三人稱，複數
V-APM-3S	動詞，簡單過去時態，被動語態，命令語氣，第三人稱，單數
V-APN	動詞，簡單過去時態，被動語態，不定語氣
V-APN-M	動詞，簡單過去時態，被動語態，不定語氣，陽性
V-APO-3S	動詞，簡單過去時態，被動語態，祈願語氣，第三人稱，單數
V-APP-APM	動詞，簡單過去時態，被動語態，分詞，直接受詞，複數，陽性
V-APP-APN	動詞，簡單過去時態，被動語態，分詞，直接受詞，複數，中性
V-APP-ASF	動詞，簡單過去時態，被動語態，分詞，直接受詞，單數，陰性
V-APP-ASM	動詞，簡單過去時態，被動語態，分詞，直接受詞，單數，陽性
V-APP-ASN	動詞，簡單過去時態，被動語態，分詞，直接受詞，單數，中性
V-APP-DPN	動詞，簡單過去時態，被動語態，分詞，間接受格，複數，中性
V-APP-DSF	動詞，簡單過去時態，被動語態，分詞，間接受格，單數，陰性
V-APP-DSM	動詞，簡單過去時態，被動語態，分詞，間接受格，單數，陽性
V-APP-GPF	動詞，簡單過去時態，被動語態，分詞，所有格，複數，陰性
V-APP-GPM	動詞，簡單過去時態，被動語態，分詞，所有格，複數，陽性
V-APP-GPN	動詞，簡單過去時態，被動語態，分詞，所有格，複數，中性
V-APP-GSF	動詞，簡單過去時態，被動語態，分詞，所有格，單數，陰性
V-APP-GSM	動詞，簡單過去時態，被動語態，分詞，所有格，單數，陽性
V-APP-GSN	動詞，簡單過去時態，被動語態，分詞，所有格，單數，中性
V-APP-NPM	動詞，簡單過去時態，被動語態，分詞，主格，複數，陽性
V-APP-NPN	動詞，簡單過去時態，被動語態，分詞，主格，複數，中性
V-APP-NSF	動詞，簡單過去時態，被動語態，分詞，主格，單數，陰性
V-APP-NSM	動詞，簡單過去時態，被動語態，分詞，主格，單數，陽性
V-APP-NSM-M	動詞，簡單過去時態，被動語態，分詞，主格，單數，陽性，關身意義
V-APP-NSN	動詞，簡單過去時態，被動語態，分詞，主格，單數，中性
V-APS-1P	動詞，簡單過去時態，被動語態，假設語氣，第一人稱，複數
V-APS-1S	動詞，簡單過去時態，被動語態，假設語氣，第一人稱，單數
V-APS-2P	動詞，簡單過去時態，被動語態，假設語氣，第二人稱，複數
V-APS-2S	動詞，簡單過去時態，被動語態，假設語氣，第二人稱，單數
V-APS-3P	動詞，簡單過去時態，被動語態，假設語氣，第三人稱，複數
V-APS-3S	動詞，簡單過去時態，被動語態，假設語氣，第三人稱，單數
V-FAI-1P	動詞，未來時態，主動，直說語氣，第一人稱，複數
V-FAI-1S	動詞，未來時態，主動，直說語氣，第一人稱，單數
V-FAI-1S-ATT	動詞，未來時態，主動，直說語氣，第一人稱，單數，阿提卡形式
V-FAI-2P	動詞，未來時態，主動，直說語氣，第二人稱，複數
V-FAI-2S	動詞，未來時態，主動，直說語氣，第二人稱，單數
V-FAI-3P	動詞，未來時態，主動，直說語氣，第三人稱，複數
V-FAI-3P-ATT	動詞，未來時態，主動，直說語氣，第三人稱，複數，阿提卡形式
V-FAI-3S	動詞，未來時態，主動，直說語氣，第三人稱，單數
V-FAI-3S-ATT	動詞，未來時態，主動，直說語氣，第三人稱，單數，阿提卡形式
V-FAN	動詞，未來時態，主動，不定語氣
V-FAP-APN	動詞，未來時態，主動，分詞，直接受詞，複數，中性
V-FAP-GPM	動詞，未來時態，主動，分詞，所有格，複數，陽性
V-FAP-NPM	動詞，未來時態，主動，分詞，主格，複數，陽性
V-FAP-NSM	動詞，未來時態，主動，分詞，主格，單數，陽性
V-FDI-1P	動詞，未來時態，關身形主動意，直說語氣，第一人稱，複數
V-FDI-1S	動詞，未來時態，關身形主動意，直說語氣，第一人稱，單數
V-FDI-2P	動詞，未來時態，關身形主動意，直說語氣，第二人稱，複數
V-FDI-2P-ATT	動詞，未來時態，關身形主動意，直說語氣，第二人稱，複數，阿提卡形式
V-FDI-2S	動詞，未來時態，關身形主動意，直說語氣，第二人稱，單數
V-FDI-2S-ATT	動詞，未來時態，關身形主動意，直說語氣，第二人稱，單數，阿提卡形式
V-FDI-3P	動詞，未來時態，關身形主動意，直說語氣，第三人稱，複數
V-FDI-3S	動詞，未來時態，關身形主動意，直說語氣，第三人稱，單數
V-FDI-3S-ATT	動詞，未來時態，關身形主動意，直說語氣，第三人稱，單數，阿提卡形式
V-FDN	動詞，未來時態，關身形主動意，不定語氣
V-FDP-ASN	動詞，未來時態，關身形主動意，分詞，直接受詞，單數，中性
V-FDP-NPM	動詞，未來時態，關身形主動意，分詞，主格，複數，陽性
V-FMI-1P	動詞，未來時態，關身語態，直說語氣，第一人稱，複數
V-FMI-1S	動詞，未來時態，關身語態，直說語氣，第一人稱，單數
V-FMI-2P	動詞，未來時態，關身語態，直說語氣，第二人稱，複數
V-FMI-2S	動詞，未來時態，關身語態，直說語氣，第二人稱，單數
V-FMI-3P	動詞，未來時態，關身語態，直說語氣，第三人稱，複數
V-FMI-3S	動詞，未來時態，關身語態，直說語氣，第三人稱，單數
V-FNI-3P	動詞，未來時態，關身形或被動形主動意，直說語氣，第三人稱，複數
V-FNI-3S	動詞，未來時態，關身形或被動形主動意，直說語氣，第三人稱，單數
V-FOI-1S	動詞，未來時態，被動形主動意，直說語氣，第一人稱，單數
V-FOI-3P	動詞，未來時態，被動形主動意，直說語氣，第三人稱，複數
V-FOI-3S	動詞，未來時態，被動形主動意，直說語氣，第三人稱，單數
V-FPI-1P	動詞，未來時態，被動語態，直說語氣，第一人稱，複數
V-FPI-1S	動詞，未來時態，被動語態，直說語氣，第一人稱，單數
V-FPI-2P	動詞，未來時態，被動語態，直說語氣，第二人稱，複數
V-FPI-2S	動詞，未來時態，被動語態，直說語氣，第二人稱，單數
V-FPI-3P	動詞，未來時態，被動語態，直說語氣，第三人稱，複數
V-FPI-3S	動詞，未來時態，被動語態，直說語氣，第三人稱，單數
V-FPP-GPN	動詞，未來時態，被動語態，分詞，所有格，複數，中性
V-FPS-1S	動詞，未來時態，被動語態，假設語氣，第一人稱，單數
V-FXI-1P	動詞，未來時態，無指定語態，直說語氣，第一人稱，複數
V-FXI-1S	動詞，未來時態，無指定語態，直說語氣，第一人稱，單數
V-FXI-2P	動詞，未來時態，無指定語態，直說語氣，第二人稱，複數
V-FXI-2S	動詞，未來時態，無指定語態，直說語氣，第二人稱，單數
V-FXI-3P	動詞，未來時態，無指定語態，直說語氣，第三人稱，複數
V-FXI-3S	動詞，未來時態，無指定語態，直說語氣，第三人稱，單數
V-FXN	動詞，未來時態，無指定語態，不定語氣
V-FXP-ASN	動詞，未來時態，無指定語態，分詞，直接受詞，單數，中性
V-FXP-NSM	動詞，未來時態，無指定語態，分詞，主格，單數，陽性
V-IAI-1P	動詞，過去不完成時態，主動，直說語氣，第一人稱，複數
V-IAI-1S	動詞，過去不完成時態，主動，直說語氣，第一人稱，單數
V-IAI-1S-ATT	動詞，過去不完成時態，主動，直說語氣，第一人稱，單數，阿提卡形式
V-IAI-2P	動詞，過去不完成時態，主動，直說語氣，第二人稱，複數
V-IAI-2S	動詞，過去不完成時態，主動，直說語氣，第二人稱，單數
V-IAI-3P	動詞，過去不完成時態，主動，直說語氣，第三人稱，複數
V-IAI-3P-ATT	動詞，過去不完成時態，主動，直說語氣，第三人稱，複數，阿提卡形式
V-IAI-3S	動詞，過去不完成時態，主動，直說語氣，第三人稱，單數
V-IAI-3S-ATT	動詞，過去不完成時態，主動，直說語氣，第三人稱，單數，阿提卡形式
V-IDI-3P	動詞，過去不完成時態，關身形主動意，直說語氣，第三人稱，複數
V-IEI-3S	動詞，過去不完成時態，關身或被動語態，直說語氣，第三人稱，單數
V-IMI-1P	動詞，過去不完成時態，關身語態，直說語氣，第一人稱，複數
V-IMI-1S	動詞，過去不完成時態，關身語態，直說語氣，第一人稱，單數
V-IMI-2P	動詞，過去不完成時態，關身語態，直說語氣，第二人稱，複數
V-IMI-2S	動詞，過去不完成時態，關身語態，直說語氣，第二人稱，單數
V-IMI-3P	動詞，過去不完成時態，關身語態，直說語氣，第三人稱，複數
V-IMI-3S	動詞，過去不完成時態，關身語態，直說語氣，第三人稱，單數
V-INI-1P	動詞，過去不完成時態，關身形或被動形主動意，直說語氣，第一人稱，複數
V-INI-1S	動詞，過去不完成時態，關身形或被動形主動意，直說語氣，第一人稱，單數
V-INI-2P	動詞，過去不完成時態，關身形或被動形主動意，直說語氣，第二人稱，複數
V-INI-2P-ATT	動詞，過去不完成時態，關身形或被動形主動意，直說語氣，第二人稱，複數，阿提卡形式
V-INI-2S	動詞，過去不完成時態，關身形或被動形主動意，直說語氣，第二人稱，單數
V-INI-3P	動詞，過去不完成時態，關身形或被動形主動意，直說語氣，第三人稱，複數
V-INI-3P-ATT	動詞，過去不完成時態，關身形或被動形主動意，直說語氣，第三人稱，複數，阿提卡形式
V-INI-3S	動詞，過去不完成時態，關身形或被動形主動意，直說語氣，第三人稱，單數
V-INI-3S-ATT	動詞，過去不完成時態，關身形或被動形主動意，直說語氣，第三人稱，單數，阿提卡形式
V-IPI-1P	動詞，過去不完成時態，被動語態，直說語氣，第一人稱，複數
V-IPI-1S	動詞，過去不完成時態，被動語態，直說語氣，第一人稱，單數
V-IPI-2P	動詞，過去不完成時態，被動語態，直說語氣，第二人稱，複數
V-IPI-3P	動詞，過去不完成時態，被動語態，直說語氣，第三人稱，複數
V-IPI-3S	動詞，過去不完成時態，被動語態，直說語氣，第三人稱，單數
V-IQI-3S	動詞，過去不完成時態，非人格主動，直說語氣，第三人稱，單數
V-IXI-1P	動詞，過去不完成時態，無指定語態，直說語氣，第一人稱，複數
V-IXI-1S	動詞，過去不完成時態，無指定語態，直說語氣，第一人稱，單數
V-IXI-2P	動詞，過去不完成時態，無指定語態，直說語氣，第二人稱，複數
V-IXI-2S	動詞，過去不完成時態，無指定語態，直說語氣，第二人稱，單數
V-IXI-3P	動詞，過去不完成時態，無指定語態，直說語氣，第三人稱，複數
V-IXI-3S	動詞，過去不完成時態，無指定語態，直說語氣，第三人稱，單數
V-LAI-1S	動詞，過去完成時態，主動，直說語氣，第一人稱，單數
V-LAI-2P	動詞，過去完成時態，主動，直說語氣，第二人稱，複數
V-LAI-2S	動詞，過去完成時態，主動，直說語氣，第二人稱，單數
V-LAI-3P	動詞，過去完成時態，主動，直說語氣，第三人稱，複數
V-LAI-3P-ATT	動詞，過去完成時態，主動，直說語氣，第三人稱，複數，阿提卡形式
V-LAI-3S	動詞，過去完成時態，主動，直說語氣，第三人稱，單數
V-LAI-3S-ATT	動詞，過去完成時態，主動，直說語氣，第三人稱，單數，阿提卡形式
V-LDI-3S	動詞，過去完成時態，關身形主動意，直說語氣，第三人稱，單數
V-LMI-3P	動詞，過去完成時態，關身語態，直說語氣，第三人稱，複數
V-LPI-3S	動詞，過去完成時態，被動語態，直說語氣，第三人稱，單數
V-PAI-1P	動詞，現在進行時態，主動，直說語氣，第一人稱，複數
V-PAI-1S	動詞，現在進行時態，主動，直說語氣，第一人稱，單數
V-PAI-1S-C	動詞，現在進行時態，主動，直說語氣，第一人稱，單數，縮略形式
V-PAI-2P	動詞，現在進行時態，主動，直說語氣，第二人稱，複數
V-PAI-2S	動詞，現在進行時態，主動，直說語氣，第二人稱，單數
V-PAI-2S-IRR	動詞，現在進行時態，主動，直說語氣，第二人稱，單數，不規則形式
V-PAI-3P	動詞，現在進行時態，主動，直說語氣，第三人稱，複數
V-PAI-3P (V-PAP-DPM)	動詞，現在進行時態，主動，直說語氣，第三人稱，複數；動詞，現在進行時態，主動，分詞，間接受格，複數，陽性
V-PAI-3P-ATT	動詞，現在進行時態，主動，直說語氣，第三人稱，複數，阿提卡形式
V-PAI-3S	動詞，現在進行時態，主動，直說語氣，第三人稱，單數
V-PAM-2P	動詞，現在進行時態，主動，命令語氣，第二人稱，複數
V-PAM-2S	動詞，現在進行時態，主動，命令語氣，第二人稱，單數
V-PAM-3P	動詞，現在進行時態，主動，命令語氣，第三人稱，複數
V-PAM-3S	動詞，現在進行時態，主動，命令語氣，第三人稱，單數
V-PAN	動詞，現在進行時態，主動，不定語氣
V-PAO-2P	動詞，現在進行時態，主動，祈願語氣，第二人稱，複數
V-PAO-3P	動詞，現在進行時態，主動，祈願語氣，第三人稱，複數
V-PAO-3S	動詞，現在進行時態，主動，祈願語氣，第三人稱，單數
V-PAP-APF	動詞，現在進行時態，主動，分詞，直接受詞，複數，陰性
V-PAP-APM	動詞，現在進行時態，主動，分詞，直接受詞，複數，陽性
V-PAP-APN	動詞，現在進行時態，主動，分詞，直接受詞，複數，中性
V-PAP-ASF	動詞，現在進行時態，主動，分詞，直接受詞，單數，陰性
V-PAP-ASM	動詞，現在進行時態，主動，分詞，直接受詞，單數，陽性
V-PAP-ASN	動詞，現在進行時態，主動，分詞，直接受詞，單數，中性
V-PAP-DPF	動詞，現在進行時態，主動，分詞，間接受格，複數，陰性
V-PAP-DPM	動詞，現在進行時態，主動，分詞，間接受格，複數，陽性
V-PAP-DPN	動詞，現在進行時態，主動，分詞，間接受格，複數，中性
V-PAP-DSF	動詞，現在進行時態，主動，分詞，間接受格，單數，陰性
V-PAP-DSM	動詞，現在進行時態，主動，分詞，間接受格，單數，陽性
V-PAP-DSN	動詞，現在進行時態，主動，分詞，間接受格，單數，中性
V-PAP-GPF	動詞，現在進行時態，主動，分詞，所有格，複數，陰性
V-PAP-GPM	動詞，現在進行時態，主動，分詞，所有格，複數，陽性
V-PAP-GPN	動詞，現在進行時態，主動，分詞，所有格，複數，中性
V-PAP-GSF	動詞，現在進行時態，主動，分詞，所有格，單數，陰性
V-PAP-GSM	動詞，現在進行時態，主動，分詞，所有格，單數，陽性
V-PAP-GSN	動詞，現在進行時態，主動，分詞，所有格，單數，中性
V-PAP-NPF	動詞，現在進行時態，主動，分詞，主格，複數，陰性
V-PAP-NPM	動詞，現在進行時態，主動，分詞，主格，複數，陽性
V-PAP-NPN	動詞，現在進行時態，主動，分詞，主格，複數，中性
V-PAP-NSF	動詞，現在進行時態，主動，分詞，主格，單數，陰性
V-PAP-NSM	動詞，現在進行時態，主動，分詞，主格，單數，陽性
V-PAP-NSN	動詞，現在進行時態，主動，分詞，主格，單數，中性
V-PAP-VPM	動詞，現在進行時態，主動，分詞，呼格，複數，陽性
V-PAP-VSF	動詞，現在進行時態，主動，分詞，呼格，單數，陰性
V-PAP-VSM	動詞，現在進行時態，主動，分詞，呼格，單數，陽性
V-PAPDP	動詞，現在進行時態，主動，分詞，間接受格，複數
V-PAS-1P	動詞，現在進行時態，主動，假設語氣，第一人稱，複數
V-PAS-1S	動詞，現在進行時態，主動，假設語氣，第一人稱，單數
V-PAS-2P	動詞，現在進行時態，主動，假設語氣，第二人稱，複數
V-PAS-2S	動詞，現在進行時態，主動，假設語氣，第二人稱，單數
V-PAS-3P	動詞，現在進行時態，主動，假設語氣，第三人稱，複數
V-PAS-3S	動詞，現在進行時態，主動，假設語氣，第三人稱，單數
V-PDP-NPM	動詞，現在進行時態，關身形主動意，分詞，主格，複數，陽性
V-PEI-1P	動詞，現在進行時態，關身或被動語態，直說語氣，第一人稱，複數
V-PEI-1S	動詞，現在進行時態，關身或被動語態，直說語氣，第一人稱，單數
V-PEI-2P	動詞，現在進行時態，關身或被動語態，直說語氣，第二人稱，複數
V-PEI-3P	動詞，現在進行時態，關身或被動語態，直說語氣，第三人稱，複數
V-PEI-3S	動詞，現在進行時態，關身或被動語態，直說語氣，第三人稱，單數
V-PEM-2P	動詞，現在進行時態，關身或被動語態，命令語氣，第二人稱，複數
V-PEM-2S	動詞，現在進行時態，關身或被動語態，命令語氣，第二人稱，單數
V-PEN	動詞，現在進行時態，關身或被動語態，不定語氣
V-PEP-ASM	動詞，現在進行時態，關身或被動語態，分詞，直接受詞，單數，陽性
V-PEP-DPM	動詞，現在進行時態，關身或被動語態，分詞，間接受格，複數，陽性
V-PEP-DSM	動詞，現在進行時態，關身或被動語態，分詞，間接受格，單數，陽性
V-PEP-GPN	動詞，現在進行時態，關身或被動語態，分詞，所有格，複數，中性
V-PEP-GSF	動詞，現在進行時態，關身或被動語態，分詞，所有格，單數，陰性
V-PEP-GSM	動詞，現在進行時態，關身或被動語態，分詞，所有格，單數，陽性
V-PEP-NPF	動詞，現在進行時態，關身或被動語態，分詞，主格，複數，陰性
V-PEP-NPM	動詞，現在進行時態，關身或被動語態，分詞，主格，複數，陽性
V-PEP-NSF	動詞，現在進行時態，關身或被動語態，分詞，主格，單數，陰性
V-PMI-1P	動詞，現在進行時態，關身語態，直說語氣，第一人稱，複數
V-PMI-1S	動詞，現在進行時態，關身語態，直說語氣，第一人稱，單數
V-PMI-2P	動詞，現在進行時態，關身語態，直說語氣，第二人稱，複數
V-PMI-2S	動詞，現在進行時態，關身語態，直說語氣，第二人稱，單數
V-PMI-3P	動詞，現在進行時態，關身語態，直說語氣，第三人稱，複數
V-PMI-3S	動詞，現在進行時態，關身語態，直說語氣，第三人稱，單數
V-PMM-2P	動詞，現在進行時態，關身語態，命令語氣，第二人稱，複數
V-PMM-2S	動詞，現在進行時態，關身語態，命令語氣，第二人稱，單數
V-PMM-3P	動詞，現在進行時態，關身語態，命令語氣，第三人稱，複數
V-PMM-3S	動詞，現在進行時態，關身語態，命令語氣，第三人稱，單數
V-PMN	動詞，現在進行時態，關身語態，不定語氣
V-PMP-APF	動詞，現在進行時態，關身語態，分詞，直接受詞，複數，陰性
V-PMP-APM	動詞，現在進行時態，關身語態，分詞，直接受詞，複數，陽性
V-PMP-APN	動詞，現在進行時態，關身語態，分詞，直接受詞，複數，中性
V-PMP-ASF	動詞，現在進行時態，關身語態，分詞，直接受詞，單數，陰性
V-PMP-ASM	動詞，現在進行時態，關身語態，分詞，直接受詞，單數，陽性
V-PMP-ASN	動詞，現在進行時態，關身語態，分詞，直接受詞，單數，中性
V-PMP-DPM	動詞，現在進行時態，關身語態，分詞，間接受格，複數，陽性
V-PMP-DSF	動詞，現在進行時態，關身語態，分詞，間接受格，單數，陰性
V-PMP-DSM	動詞，現在進行時態，關身語態，分詞，間接受格，單數，陽性
V-PMP-GPF	動詞，現在進行時態，關身語態，分詞，所有格，複數，陰性
V-PMP-GPM	動詞，現在進行時態，關身語態，分詞，所有格，複數，陽性
V-PMP-GPN	動詞，現在進行時態，關身語態，分詞，所有格，複數，中性
V-PMP-GSF	動詞，現在進行時態，關身語態，分詞，所有格，單數，陰性
V-PMP-GSM	動詞，現在進行時態，關身語態，分詞，所有格，單數，陽性
V-PMP-GSM-T	動詞，現在進行時態，關身語態，分詞，所有格，單數，陽性，及物
V-PMP-GSN	動詞，現在進行時態，關身語態，分詞，所有格，單數，中性
V-PMP-NPF	動詞，現在進行時態，關身語態，分詞，主格，複數，陰性
V-PMP-NPM	動詞，現在進行時態，關身語態，分詞，主格，複數，陽性
V-PMP-NSF	動詞，現在進行時態，關身語態，分詞，主格，單數，陰性
V-PMP-NSM	動詞，現在進行時態，關身語態，分詞，主格，單數，陽性
V-PMP-NSN	動詞，現在進行時態，關身語態，分詞，主格，單數，中性
V-PMS-1P	動詞，現在進行時態，關身語態，假設語氣，第一人稱，複數
V-PMS-1S	動詞，現在進行時態，關身語態，假設語氣，第一人稱，單數
V-PMS-2S	動詞，現在進行時態，關身語態，假設語氣，第二人稱，單數
V-PMS-3S	動詞，現在進行時態，關身語態，假設語氣，第三人稱，單數
V-PNI-1P	動詞，現在進行時態，關身形或被動形主動意，直說語氣，第一人稱，複數
V-PNI-1S	動詞，現在進行時態，關身形或被動形主動意，直說語氣，第一人稱，單數
V-PNI-1S-C	動詞，現在進行時態，關身形或被動形主動意，直說語氣，第一人稱，單數，縮略形式
V-PNI-2P	動詞，現在進行時態，關身形或被動形主動意，直說語氣，第二人稱，複數
V-PNI-2S	動詞，現在進行時態，關身形或被動形主動意，直說語氣，第二人稱，單數
V-PNI-2S-ATT	動詞，現在進行時態，關身形或被動形主動意，直說語氣，第二人稱，單數，阿提卡形式
V-PNI-2S-C	動詞，現在進行時態，關身形或被動形主動意，直說語氣，第二人稱，單數，縮略形式
V-PNI-3P	動詞，現在進行時態，關身形或被動形主動意，直說語氣，第三人稱，複數
V-PNI-3S	動詞，現在進行時態，關身形或被動形主動意，直說語氣，第三人稱，單數
V-PNI-3S-I	動詞，現在進行時態，關身形或被動形主動意，直說語氣，第三人稱，單數
V-PNM-2P	動詞，現在進行時態，關身形或被動形主動意，命令語氣，第二人稱，複數
V-PNM-2S	動詞，現在進行時態，關身形或被動形主動意，命令語氣，第二人稱，單數
V-PNM-3P	動詞，現在進行時態，關身形或被動形主動意，命令語氣，第三人稱，複數
V-PNM-3S	動詞，現在進行時態，關身形或被動形主動意，命令語氣，第三人稱，單數
V-PNN	動詞，現在進行時態，關身形或被動形主動意，不定語氣
V-PNO-1S	動詞，現在進行時態，關身形或被動形主動意，祈願語氣，第一人稱，單數
V-PNO-3P	動詞，現在進行時態，關身形或被動形主動意，祈願語氣，第三人稱，複數
V-PNO-3S	動詞，現在進行時態，關身形或被動形主動意，祈願語氣，第三人稱，單數
V-PNP-APF	動詞，現在進行時態，關身形或被動形主動意，分詞，直接受詞，複數，陰性
V-PNP-APM	動詞，現在進行時態，關身形或被動形主動意，分詞，直接受詞，複數，陽性
V-PNP-APN	動詞，現在進行時態，關身形或被動形主動意，分詞，直接受詞，複數，中性
V-PNP-ASF	動詞，現在進行時態，關身形或被動形主動意，分詞，直接受詞，單數，陰性
V-PNP-ASM	動詞，現在進行時態，關身形或被動形主動意，分詞，直接受詞，單數，陽性
V-PNP-ASN	動詞，現在進行時態，關身形或被動形主動意，分詞，直接受詞，單數，中性
V-PNP-DPF	動詞，現在進行時態，關身形或被動形主動意，分詞，間接受格，複數，陰性
V-PNP-DPM	動詞，現在進行時態，關身形或被動形主動意，分詞，間接受格，複數，陽性
V-PNP-DPN	動詞，現在進行時態，關身形或被動形主動意，分詞，間接受格，複數，中性
V-PNP-DSF	動詞，現在進行時態，關身形或被動形主動意，分詞，間接受格，單數，陰性
V-PNP-DSM	動詞，現在進行時態，關身形或被動形主動意，分詞，間接受格，單數，陽性
V-PNP-DSN	動詞，現在進行時態，關身形或被動形主動意，分詞，間接受格，單數，中性
V-PNP-GPF	動詞，現在進行時態，關身形或被動形主動意，分詞，所有格，複數，陰性
V-PNP-GPM	動詞，現在進行時態，關身形或被動形主動意，分詞，所有格，複數，陽性
V-PNP-GPN	動詞，現在進行時態，關身形或被動形主動意，分詞，所有格，複數，中性
V-PNP-GSF	動詞，現在進行時態，關身形或被動形主動意，分詞，所有格，單數，陰性
V-PNP-GSM	動詞，現在進行時態，關身形或被動形主動意，分詞，所有格，單數，陽性
V-PNP-GSN	動詞，現在進行時態，關身形或被動形主動意，分詞，所有格，單數，中性
V-PNP-NPF	動詞，現在進行時態，關身形或被動形主動意，分詞，主格，複數，陰性
V-PNP-NPM	動詞，現在進行時態，關身形或被動形主動意，分詞，主格，複數，陽性
V-PNP-NPN	動詞，現在進行時態，關身形或被動形主動意，分詞，主格，複數，中性
V-PNP-NSF	動詞，現在進行時態，關身形或被動形主動意，分詞，主格，單數，陰性
V-PNP-NSM	動詞，現在進行時態，關身形或被動形主動意，分詞，主格，單數，陽性
V-PNP-NSN	動詞，現在進行時態，關身形或被動形主動意，分詞，主格，單數，中性
V-PNP-VPM	動詞，現在進行時態，關身形或被動形主動意，分詞，呼格，複數，陽性
V-PNP-VSM	動詞，現在進行時態，關身形或被動形主動意，分詞，呼格，單數，陽性
V-PNS-1P	動詞，現在進行時態，關身形或被動形主動意，假設語氣，第一人稱，複數
V-PNS-1S	動詞，現在進行時態，關身形或被動形主動意，假設語氣，第一人稱，單數
V-PNS-2P	動詞，現在進行時態，關身形或被動形主動意，假設語氣，第二人稱，複數
V-PNS-2S	動詞，現在進行時態，關身形或被動形主動意，假設語氣，第二人稱，單數
V-PNS-3P	動詞，現在進行時態，關身形或被動形主動意，假設語氣，第三人稱，複數
V-PNS-3S	動詞，現在進行時態，關身形或被動形主動意，假設語氣，第三人稱，單數
V-POP-NPM	動詞，現在進行時態，被動形主動意，分詞，主格，複數，陽性
V-PPI-1P	動詞，現在進行時態，被動語態，直說語氣，第一人稱，複數
V-PPI-1S	動詞，現在進行時態，被動語態，直說語氣，第一人稱，單數
V-PPI-2P	動詞，現在進行時態，被動語態，直說語氣，第二人稱，複數
V-PPI-2S	動詞，現在進行時態，被動語態，直說語氣，第二人稱，單數
V-PPI-2S-IRR	動詞，現在進行時態，被動語態，直說語氣，第二人稱，單數，不規則形式
V-PPI-3P	動詞，現在進行時態，被動語態，直說語氣，第三人稱，複數
V-PPI-3S	動詞，現在進行時態，被動語態，直說語氣，第三人稱，單數
V-PPM-2P	動詞，現在進行時態，被動語態，命令語氣，第二人稱，複數
V-PPM-2S	動詞，現在進行時態，被動語態，命令語氣，第二人稱，單數
V-PPM-3P	動詞，現在進行時態，被動語態，命令語氣，第三人稱，複數
V-PPM-3S	動詞，現在進行時態，被動語態，命令語氣，第三人稱，單數
V-PPN	動詞，現在進行時態，被動語態，不定語氣
V-PPN-2P	動詞，現在進行時態，被動語態，不定語氣，第二人稱，複數
V-PPP-APF	動詞，現在進行時態，被動語態，分詞，直接受詞，複數，陰性
V-PPP-APM	動詞，現在進行時態，被動語態，分詞，直接受詞，複數，陽性
V-PPP-APN	動詞，現在進行時態，被動語態，分詞，直接受詞，複數，中性
V-PPP-ASF	動詞，現在進行時態，被動語態，分詞，直接受詞，單數，陰性
V-PPP-ASM	動詞，現在進行時態，被動語態，分詞，直接受詞，單數，陽性
V-PPP-ASN	動詞，現在進行時態，被動語態，分詞，直接受詞，單數，中性
V-PPP-DPM	動詞，現在進行時態，被動語態，分詞，間接受格，複數，陽性
V-PPP-DPN	動詞，現在進行時態，被動語態，分詞，間接受格，複數，中性
V-PPP-DSF	動詞，現在進行時態，被動語態，分詞，間接受格，單數，陰性
V-PPP-DSM	動詞，現在進行時態，被動語態，分詞，間接受格，單數，陽性
V-PPP-DSN	動詞，現在進行時態，被動語態，分詞，間接受格，單數，中性
V-PPP-GPM	動詞，現在進行時態，被動語態，分詞，所有格，複數，陽性
V-PPP-GPN	動詞，現在進行時態，被動語態，分詞，所有格，複數，中性
V-PPP-GSF	動詞，現在進行時態，被動語態，分詞，所有格，單數，陰性
V-PPP-GSM	動詞，現在進行時態，被動語態，分詞，所有格，單數，陽性
V-PPP-GSN	動詞，現在進行時態，被動語態，分詞，所有格，單數，中性
V-PPP-NPF	動詞，現在進行時態，被動語態，分詞，主格，複數，陰性
V-PPP-NPM	動詞，現在進行時態，被動語態，分詞，主格，複數，陽性
V-PPP-NPN	動詞，現在進行時態，被動語態，分詞，主格，複數，中性
V-PPP-NSF	動詞，現在進行時態，被動語態，分詞，主格，單數，陰性
V-PPP-NSM	動詞，現在進行時態，被動語態，分詞，主格，單數，陽性
V-PPP-NSN	動詞，現在進行時態，被動語態，分詞，主格，單數，中性
V-PPS-1P	動詞，現在進行時態，被動語態，假設語氣，第一人稱，複數
V-PPS-1S	動詞，現在進行時態，被動語態，假設語氣，第一人稱，單數
V-PPS-2P	動詞，現在進行時態，被動語態，假設語氣，第二人稱，複數
V-PPS-3P	動詞，現在進行時態，被動語態，假設語氣，第三人稱，複數
V-PPS-3S	動詞，現在進行時態，被動語態，假設語氣，第三人稱，單數
V-PQI-3S	動詞，現在進行時態，非人格主動，直說語氣，第三人稱，單數
V-PQN	動詞，現在進行時態，非人格主動，不定語氣
V-PQP-APN	動詞，現在進行時態，非人格主動，分詞，直接受詞，複數，中性
V-PQP-NSN	動詞，現在進行時態，非人格主動，分詞，主格，單數，中性
V-PQS-3S	動詞，現在進行時態，非人格主動，假設語氣，第三人稱，單數
V-PXI-1P	動詞，現在進行時態，無指定語態，直說語氣，第一人稱，複數
V-PXI-1S	動詞，現在進行時態，無指定語態，直說語氣，第一人稱，單數
V-PXI-2P	動詞，現在進行時態，無指定語態，直說語氣，第二人稱，複數
V-PXI-2S	動詞，現在進行時態，無指定語態，直說語氣，第二人稱，單數
V-PXI-3P	動詞，現在進行時態，無指定語態，直說語氣，第三人稱，複數
V-PXI-3S	動詞，現在進行時態，無指定語態，直說語氣，第三人稱，單數
V-PXM-2S	動詞，現在進行時態，無指定語態，命令語氣，第二人稱，單數
V-PXM-3P	動詞，現在進行時態，無指定語態，命令語氣，第三人稱，複數
V-PXM-3S	動詞，現在進行時態，無指定語態，命令語氣，第三人稱，單數
V-PXN	動詞，現在進行時態，無指定語態，不定語氣
V-PXO-2S	動詞，現在進行時態，無指定語態，祈願語氣，第二人稱，單數
V-PXO-3S	動詞，現在進行時態，無指定語態，祈願語氣，第三人稱，單數
V-PXP-APM	動詞，現在進行時態，無指定語態，分詞，直接受詞，複數，陽性
V-PXP-APN	動詞，現在進行時態，無指定語態，分詞，直接受詞，複數，中性
V-PXP-ASF	動詞，現在進行時態，無指定語態，分詞，直接受詞，單數，陰性
V-PXP-ASM	動詞，現在進行時態，無指定語態，分詞，直接受詞，單數，陽性
V-PXP-ASN	動詞，現在進行時態，無指定語態，分詞，直接受詞，單數，中性
V-PXP-DPM	動詞，現在進行時態，無指定語態，分詞，間接受格，複數，陽性
V-PXP-DPN	動詞，現在進行時態，無指定語態，分詞，間接受格，複數，中性
V-PXP-DSF	動詞，現在進行時態，無指定語態，分詞，間接受格，單數，陰性
V-PXP-DSM	動詞，現在進行時態，無指定語態，分詞，間接受格，單數，陽性
V-PXP-GPF	動詞，現在進行時態，無指定語態，分詞，所有格，複數，陰性
V-PXP-GPM	動詞，現在進行時態，無指定語態，分詞，所有格，複數，陽性
V-PXP-GPN	動詞，現在進行時態，無指定語態，分詞，所有格，複數，中性
V-PXP-GSF	動詞，現在進行時態，無指定語態，分詞，所有格，單數，陰性
V-PXP-GSM	動詞，現在進行時態，無指定語態，分詞，所有格，單數，陽性
V-PXP-GSN	動詞，現在進行時態，無指定語態，分詞，所有格，單數，中性
V-PXP-NPF	動詞，現在進行時態，無指定語態，分詞，主格，複數，陰性
V-PXP-NPM	動詞，現在進行時態，無指定語態，分詞，主格，複數，陽性
V-PXP-NPN	動詞，現在進行時態，無指定語態，分詞，主格，複數，中性
V-PXP-NSF	動詞，現在進行時態，無指定語態，分詞，主格，單數，陰性
V-PXP-NSM	動詞，現在進行時態，無指定語態，分詞，主格，單數，陽性
V-PXP-NSN	動詞，現在進行時態，無指定語態，分詞，主格，單數，中性
V-PXS-1P	動詞，現在進行時態，無指定語態，假設語氣，第一人稱，複數
V-PXS-1S	動詞，現在進行時態，無指定語態，假設語氣，第一人稱，單數
V-PXS-2P	動詞，現在進行時態，無指定語態，假設語氣，第二人稱，複數
V-PXS-2S	動詞，現在進行時態，無指定語態，假設語氣，第二人稱，單數
V-PXS-3P	動詞，現在進行時態，無指定語態，假設語氣，第三人稱，複數
V-PXS-3S	動詞，現在進行時態，無指定語態，假設語氣，第三人稱，單數
V-RAI-1P	動詞，現在完成時態，主動，直說語氣，第一人稱，複數
V-RAI-1P-ATT	動詞，現在完成時態，主動，直說語氣，第一人稱，複數，阿提卡形式
V-RAI-1S	動詞，現在完成時態，主動，直說語氣，第一人稱，單數
V-RAI-1S-ATT	動詞，現在完成時態，主動，直說語氣，第一人稱，單數，阿提卡形式
V-RAI-2P	動詞，現在完成時態，主動，直說語氣，第二人稱，複數
V-RAI-2P-ATT	動詞，現在完成時態，主動，直說語氣，第二人稱，複數，阿提卡形式
V-RAI-2S	動詞，現在完成時態，主動，直說語氣，第二人稱，單數
V-RAI-2S-ATT	動詞，現在完成時態，主動，直說語氣，第二人稱，單數，阿提卡形式
V-RAI-3P	動詞，現在完成時態，主動，直說語氣，第三人稱，複數
V-RAI-3P-ATT	動詞，現在完成時態，主動，直說語氣，第三人稱，複數，阿提卡形式
V-RAI-3S	動詞，現在完成時態，主動，直說語氣，第三人稱，單數
V-RAI-3S-ATT	動詞，現在完成時態，主動，直說語氣，第三人稱，單數，阿提卡形式
V-RAM-2P	動詞，現在完成時態，主動，命令語氣，第二人稱，複數
V-RAN	動詞，現在完成時態，主動，不定語氣
V-RAN-ATT	動詞，現在完成時態，主動，不定語氣，直接受詞
V-RAP-APM	動詞，現在完成時態，主動，分詞，直接受詞，複數，陽性
V-RAP-APN	動詞，現在完成時態，主動，分詞，直接受詞，複數，中性
V-RAP-ASF	動詞，現在完成時態，主動，分詞，直接受詞，單數，陰性
V-RAP-ASM	動詞，現在完成時態，主動，分詞，直接受詞，單數，陽性
V-RAP-ASM-C	動詞，現在完成時態，主動，分詞，直接受詞，單數，陽性，縮略形式
V-RAP-ASN	動詞，現在完成時態，主動，分詞，直接受詞，單數，中性
V-RAP-DPM	動詞，現在完成時態，主動，分詞，間接受格，複數，陽性
V-RAP-DSM	動詞，現在完成時態，主動，分詞，間接受格，單數，陽性
V-RAP-DSN	動詞，現在完成時態，主動，分詞，間接受格，單數，中性
V-RAP-GPM	動詞，現在完成時態，主動，分詞，所有格，複數，陽性
V-RAP-GPN	動詞，現在完成時態，主動，分詞，所有格，複數，中性
V-RAP-GSF	動詞，現在完成時態，主動，分詞，所有格，單數，陰性
V-RAP-GSM	動詞，現在完成時態，主動，分詞，所有格，單數，陽性
V-RAP-GSM-ATT	動詞，現在完成時態，主動，分詞，所有格，單數，陽性，阿提卡形式
V-RAP-GSN-ATT	動詞，現在完成時態，主動，分詞，所有格，單數，中性，阿提卡形式
V-RAP-NPF	動詞，現在完成時態，主動，分詞，主格，複數，陰性
V-RAP-NPM	動詞，現在完成時態，主動，分詞，主格，複數，陽性
V-RAP-NPM-ATT	動詞，現在完成時態，主動，分詞，主格，複數，陽性，阿提卡形式
V-RAP-NPM-C	動詞，現在完成時態，主動，分詞，主格，複數，陽性，縮略形式
V-RAP-NPN	動詞，現在完成時態，主動，分詞，主格，複數，中性
V-RAP-NSF	動詞，現在完成時態，主動，分詞，主格，單數，陰性
V-RAP-NSM	動詞，現在完成時態，主動，分詞，主格，單數，陽性
V-RAP-NSM-ATT	動詞，現在完成時態，主動，分詞，主格，單數，陽性，阿提卡形式
V-RAP-NSN	動詞，現在完成時態，主動，分詞，主格，單數，中性
V-RAS-1P	動詞，現在完成時態，主動，假設語氣，第一人稱，複數
V-RAS-1S	動詞，現在完成時態，主動，假設語氣，第一人稱，單數
V-RAS-2P	動詞，現在完成時態，主動，假設語氣，第二人稱，複數
V-RAS-2S	動詞，現在完成時態，主動，假設語氣，第二人稱，單數
V-RDI-3S	動詞，現在完成時態，關身形主動意，直說語氣，第三人稱，單數
V-REP-NSF	動詞，現在完成時態，關身或被動語態，分詞，主格，單數，陰性
V-REP-VSF	動詞，現在完成時態，關身或被動語態，分詞，呼格，單數，陰性
V-RMI-1S	動詞，現在完成時態，關身語態，直說語氣，第一人稱，單數
V-RMI-2P	動詞，現在完成時態，關身語態，直說語氣，第二人稱，複數
V-RMI-2S	動詞，現在完成時態，關身語態，直說語氣，第二人稱，單數
V-RMI-3S	動詞，現在完成時態，關身語態，直說語氣，第三人稱，單數
V-RMM-2P	動詞，現在完成時態，關身語態，命令語氣，第二人稱，複數
V-RMP-APM	動詞，現在完成時態，關身語態，分詞，直接受詞，複數，陽性
V-RMP-ASM	動詞，現在完成時態，關身語態，分詞，直接受詞，單數，陽性
V-RMP-DPM	動詞，現在完成時態，關身語態，分詞，間接受格，複數，陽性
V-RMP-GPM	動詞，現在完成時態，關身語態，分詞，所有格，複數，陽性
V-RMP-GSF	動詞，現在完成時態，關身語態，分詞，所有格，單數，陰性
V-RMP-NPM	動詞，現在完成時態，關身語態，分詞，主格，複數，陽性
V-RMP-NSM	動詞，現在完成時態，關身語態，分詞，主格，單數，陽性
V-RNI-1P	動詞，現在完成時態，關身形或被動形主動意，直說語氣，第一人稱，複數
V-RNI-1S	動詞，現在完成時態，關身形或被動形主動意，直說語氣，第一人稱，單數
V-RNI-3S	動詞，現在完成時態，關身形或被動形主動意，直說語氣，第三人稱，單數
V-RNN	動詞，現在完成時態，關身形或被動形主動意，不定語氣
V-RNP-APM	動詞，現在完成時態，關身形或被動形主動意，分詞，直接受詞，複數，陽性
V-RNP-ASF	動詞，現在完成時態，關身形或被動形主動意，分詞，直接受詞，單數，陰性
V-RNP-DPF	動詞，現在完成時態，關身形或被動形主動意，分詞，間接受格，複數，陰性
V-RNP-NPM	動詞，現在完成時態，關身形或被動形主動意，分詞，主格，複數，陽性
V-RNP-NSM	動詞，現在完成時態，關身形或被動形主動意，分詞，主格，單數，陽性
V-RPI-1P	動詞，現在完成時態，被動語態，直說語氣，第一人稱，複數
V-RPI-1S	動詞，現在完成時態，被動語態，直說語氣，第一人稱，單數
V-RPI-2P	動詞，現在完成時態，被動語態，直說語氣，第二人稱，複數
V-RPI-2S	動詞，現在完成時態，被動語態，直說語氣，第二人稱，單數
V-RPI-3P	動詞，現在完成時態，被動語態，直說語氣，第三人稱，複數
V-RPI-3S	動詞，現在完成時態，被動語態，直說語氣，第三人稱，單數
V-RPM-2P	動詞，現在完成時態，被動語態，命令語氣，第二人稱，複數
V-RPM-2S	動詞，現在完成時態，被動語態，命令語氣，第二人稱，單數
V-RPN	動詞，現在完成時態，被動語態，不定語氣
V-RPP-APF	動詞，現在完成時態，被動語態，分詞，直接受詞，複數，陰性
V-RPP-APM	動詞，現在完成時態，被動語態，分詞，直接受詞，複數，陽性
V-RPP-APN	動詞，現在完成時態，被動語態，分詞，直接受詞，複數，中性
V-RPP-ASF	動詞，現在完成時態，被動語態，分詞，直接受詞，單數，陰性
V-RPP-ASM	動詞，現在完成時態，被動語態，分詞，直接受詞，單數，陽性
V-RPP-ASN	動詞，現在完成時態，被動語態，分詞，直接受詞，單數，中性
V-RPP-ASN-ATT	動詞，現在完成時態，被動語態，分詞，直接受詞，單數，中性，阿提卡形式
V-RPP-DPM	動詞，現在完成時態，被動語態，分詞，間接受格，複數，陽性
V-RPP-DPN	動詞，現在完成時態，被動語態，分詞，間接受格，複數，中性
V-RPP-DSF	動詞，現在完成時態，被動語態，分詞，間接受格，單數，陰性
V-RPP-DSM	動詞，現在完成時態，被動語態，分詞，間接受格，單數，陽性
V-RPP-DSN	動詞，現在完成時態，被動語態，分詞，間接受格，單數，中性
V-RPP-GPF	動詞，現在完成時態，被動語態，分詞，所有格，複數，陰性
V-RPP-GPM	動詞，現在完成時態，被動語態，分詞，所有格，複數，陽性
V-RPP-GPN	動詞，現在完成時態，被動語態，分詞，所有格，複數，中性
V-RPP-GSF	動詞，現在完成時態，被動語態，分詞，所有格，單數，陰性
V-RPP-GSM	動詞，現在完成時態，被動語態，分詞，所有格，單數，陽性
V-RPP-GSN	動詞，現在完成時態，被動語態，分詞，所有格，單數，中性
V-RPP-NPF	動詞，現在完成時態，被動語態，分詞，主格，複數，陰性
V-RPP-NPM	動詞，現在完成時態，被動語態，分詞，主格，複數，陽性
V-RPP-NPN	動詞，現在完成時態，被動語態，分詞，主格，複數，中性
V-RPP-NSF	動詞，現在完成時態，被動語態，分詞，主格，單數，陰性
V-RPP-NSM	動詞，現在完成時態，被動語態，分詞，主格，單數，陽性
V-RPP-NSN	動詞，現在完成時態，被動語態，分詞，主格，單數，中性
V-RPP-NSN-ATT	動詞，現在完成時態，被動語態，分詞，主格，單數，中性，阿提卡形式
V-RPP-VPM	動詞，現在完成時態，被動語態，分詞，呼格，複數，陽性
V-RPP-VSF	動詞，現在完成時態，被動語態，分詞，呼格，單數，陰性
V-RPP-VSM	動詞，現在完成時態，被動語態，分詞，呼格，單數，陽性
V-XXM-2P	動詞，無指定時態，無指定語態，命令語氣，第二人稱，複數
V-XXM-2S	動詞，無指定時態，無指定語態，命令語氣，第二人稱，單數
X-APF	不定代名詞，直接受詞，複數，陰性
X-APM	不定代名詞，直接受詞，複數，陽性
X-APN	不定代名詞，直接受詞，複數，中性
X-ASF	不定代名詞，直接受詞，單數，陰性
X-ASM	不定代名詞，直接受詞，單數，陽性
X-ASN	不定代名詞，直接受詞，單數，中性
X-DPM	不定代名詞，間接受格，複數，陽性
X-DSF	不定代名詞，間接受格，單數，陰性
X-DSM	不定代名詞，間接受格，單數，陽性
X-DSN	不定代名詞，間接受格，單數，中性
X-GPF	不定代名詞，所有格，複數，陰性
X-GPM	不定代名詞，所有格，複數，陽性
X-GPN	不定代名詞，所有格，複數，中性
X-GSF	不定代名詞，所有格，單數，陰性
X-GSM	不定代名詞，所有格，單數，陽性
X-GSN	不定代名詞，所有格，單數，中性
X-NPF	不定代名詞，主格，複數，陰性
X-NPM	不定代名詞，主格，複數，陽性
X-NPN	不定代名詞，主格，複數，中性
X-NSF	不定代名詞，主格，單數，陰性
X-NSM	不定代名詞，主格，單數，陽性
X-NSN	不定代名詞，主格，單數，中性
